5 5 5 5 5 5 5 5 5 5 5 5 5 5 5 5 5 5 5 5 5 5 5 5 5 5 5 5 5 5 5 5 5 5 5 5 5 5 5 5 5 5 5 5 5 5 5 5 5 5 5 5 5 5 5 5 5 5 5 5 5 5 5 5 5 5 5 5 5 5 5 5 5 5 5 5 5 5 5 5 5 5 9 9 114 115 116 9 9 5 5 5 5 5 5 5 5 5 5 5 
5 5 5 5 5 5 5 5 5 5 5 5 5 5 5 5 9 9 9 18 16 19 9 9 9 9 5 5 5 5 5 5 5 5 5 5 5 5 5 5 5 5 5 5 5 5 5 5 5 5 5 5 5 5 5 5 5 5 5 5 5 5 5 5 5 5 5 5 5 5 5 5 5 5 5 5 5 5 5 5 5 5 5 186 117 118 119 188 5 5 5 5 5 5 5 5 5 5 5 5 
5 5 5 5 5 5 5 5 5 5 5 5 5 5 5 5 9 9 9 14 6 13 9 9 9 9 5 5 5 5 5 5 5 5 5 5 5 5 5 5 5 5 5 5 5 5 5 5 5 5 5 5 5 5 5 5 5 5 5 5 5 5 5 5 5 5 5 5 5 5 5 5 5 5 5 5 5 5 5 5 5 5 5 190 191 191 191 192 5 5 5 5 5 5 5 5 5 5 5 5 
5 5 5 5 5 5 5 5 5 5 5 5 5 5 5 5 9 9 9 14 6 13 9 9 9 9 5 5 5 5 5 5 5 5 5 5 5 5 5 5 5 5 5 5 5 5 5 5 5 5 5 5 5 5 5 5 5 5 5 5 5 5 5 5 5 5 5 5 5 5 5 5 5 5 5 5 5 5 5 5 5 5 5 195 196 196 196 197 5 5 5 5 5 5 5 5 5 5 5 5 
5 5 5 5 5 5 5 5 5 5 5 5 5 5 5 5 9 9 1 14 6 13 9 9 9 9 5 5 5 5 5 5 5 5 5 5 5 5 5 5 5 5 5 5 5 5 5 5 5 5 5 5 5 5 5 5 5 5 5 5 5 5 5 5 5 5 5 5 5 5 5 5 5 5 5 5 5 5 5 5 5 5 5 126 127 128 129 130 5 5 5 5 5 5 5 5 5 5 5 5 
5 5 5 5 5 5 5 5 5 5 5 5 5 5 5 5 5 5 9 114 115 116 9 5 5 5 5 5 5 5 5 5 5 5 5 5 5 5 5 5 5 5 5 5 5 5 5 5 5 5 5 5 5 5 5 5 5 5 5 5 5 5 5 5 5 5 5 5 5 5 5 5 5 5 5 5 5 5 5 5 5 5 5 131 132 133 134 135 5 5 5 5 5 5 5 5 5 5 5 5 
5 5 5 5 5 5 5 5 5 5 5 5 5 5 5 5 5 5 186 117 118 119 188 5 5 5 5 5 5 5 5 5 5 5 5 5 5 5 5 5 5 5 5 5 5 5 5 5 5 5 5 5 5 5 5 5 5 5 5 5 5 5 5 5 5 5 5 5 5 5 5 5 5 5 5 5 5 5 5 5 5 5 9 9 136 137 138 9 249 5 5 5 5 5 5 5 5 5 5 5 
5 5 5 5 5 5 5 5 5 5 5 5 5 5 5 5 5 5 190 191 191 191 192 5 5 5 5 5 5 5 5 5 5 5 5 5 5 5 5 5 5 5 5 5 5 5 5 5 5 5 5 5 5 5 5 5 5 5 5 5 5 5 5 5 5 5 5 5 5 5 5 5 5 5 5 5 5 5 5 5 5 9 1 9 14 6 13 9 9 5 5 5 5 5 5 5 5 5 5 5 
5 5 5 5 5 5 5 5 5 5 5 5 5 5 5 5 5 5 195 196 196 196 197 5 5 5 5 5 5 5 5 5 5 5 5 5 5 5 5 5 5 5 5 5 5 5 5 5 5 5 5 5 5 5 5 5 5 5 5 5 5 5 5 5 5 5 5 5 5 5 5 5 5 5 5 5 5 5 5 5 5 249 9 9 14 6 13 1 9 5 5 5 5 5 5 5 5 5 5 5 
5 5 5 5 5 5 5 5 5 5 5 5 5 5 5 5 5 5 126 127 128 129 130 5 5 5 5 5 5 5 5 5 5 5 5 5 5 5 5 5 5 5 5 5 5 5 5 5 5 5 5 9 414 9 5 5 5 5 5 5 5 5 5 5 9 5 5 5 5 5 5 1 5 5 5 5 5 5 5 5 5 5 5 5 14 6 13 5 5 5 5 5 5 5 5 5 5 5 5 5 
5 5 5 5 5 5 5 5 5 5 5 5 5 5 5 5 5 5 131 132 133 134 135 5 5 5 5 5 5 5 5 5 5 5 5 5 5 5 5 5 5 5 5 5 5 5 5 5 5 5 9 9 413 9 1 5 5 5 9 9 9 5 5 5 9 1 9 9 9 5 5 9 5 5 5 5 5 5 5 5 249 9 1 9 14 6 13 9 1 9 5 5 5 5 5 5 5 5 5 5 
5 5 5 5 5 5 5 5 5 5 5 5 5 5 5 5 9 9 9 136 137 138 9 1 9 9 5 5 5 5 9 9 1 9 9 9 1 9 9 9 9 9 1 9 5 9 9 9 5 5 9 1 9 9 9 5 5 5 9 5 1 9 5 5 5 5 5 5 1 5 5 9 5 5 5 5 5 5 5 9 9 5 9 9 14 6 13 9 9 249 9 9 5 5 5 5 5 5 5 5 
5 5 5 5 5 5 5 5 5 5 5 5 5 5 5 5 9 9 18 17 6 15 19 9 9 9 5 5 5 5 5 5 5 5 5 5 5 5 5 5 5 5 5 9 5 1 5 9 5 5 9 5 9 5 9 9 9 9 1 5 5 9 9 1 9 9 9 5 9 5 5 1 5 5 5 5 5 5 5 1 9 9 9 9 14 6 13 9 9 9 9 1 5 5 5 5 5 5 5 5 
5 5 5 5 5 5 5 5 5 5 5 5 5 5 5 5 1 9 14 6 6 6 13 9 1 9 5 5 9 1 9 9 5 9 9 5 9 9 9 5 5 5 5 9 5 9 5 9 5 5 1 5 9 9 5 9 5 5 5 5 5 5 5 5 5 5 1 5 9 5 5 9 5 5 5 5 5 5 5 5 9 249 9 1 20 11 21 9 9 249 9 249 5 5 5 5 5 25 26 26 
5 5 5 5 5 5 5 5 5 5 5 5 5 5 5 5 9 9 20 11 11 11 21 9 9 9 5 5 5 9 5 9 9 1 5 9 1 5 9 1 9 9 9 9 5 9 5 1 5 5 9 5 5 9 5 1 5 9 9 9 1 5 5 1 5 5 9 9 9 9 1 9 9 5 5 5 5 5 5 5 9 9 9 9 9 9 1 9 9 9 249 9 5 5 5 25 26 36 24 3 
5 5 5 5 5 5 5 5 5 5 5 5 5 5 5 5 1 9 9 5 5 5 5 41 40 42 5 5 9 9 1 5 5 5 9 9 5 5 5 5 5 9 5 5 5 9 5 9 5 5 9 9 5 1 5 9 5 9 5 5 9 5 1 9 9 5 9 5 1 5 9 5 5 5 5 5 5 5 5 9 1 9 9 1 9 9 9 9 9 9 249 9 5 25 26 36 24 3 24 24 
5 5 5 5 5 5 5 5 5 5 5 5 5 5 5 5 9 1 9 5 9 1 44 9 9 9 5 5 9 5 9 9 5 5 9 5 5 9 9 9 9 1 9 9 5 1 5 9 5 5 9 1 5 9 5 9 5 9 5 9 1 5 5 9 9 5 1 5 5 301 350 302 303 5 5 5 5 5 5 249 9 9 9 9 9 9 9 9 1 249 1 25 368 36 24 24 24 24 33 31 
5 5 5 5 5 5 5 5 5 5 5 5 5 5 5 5 9 9 9 5 9 9 43 1 9 9 5 5 1 9 5 9 9 5 9 5 9 1 5 5 5 5 5 5 5 9 5 9 5 5 38 39 5 9 5 9 9 1 5 9 5 5 5 1 5 5 5 5 301 312 350 300 311 303 5 5 5 5 5 5 249 9 9 9 8 8 8 9 9 25 26 36 367 24 24 3 33 31 32 5 
5 5 5 5 5 5 5 5 5 5 5 5 5 5 5 5 1 9 9 5 1 9 45 9 9 1 5 5 5 5 5 5 1 9 9 5 9 5 5 9 9 9 1 9 9 9 5 9 5 5 9 9 5 9 5 5 5 5 5 9 5 5 9 9 9 9 5 5 306 310 350 300 309 308 5 5 5 5 5 5 9 1 9 9 8 8 8 25 26 36 24 24 367 24 33 31 32 5 5 5 
5 5 5 5 5 5 5 5 5 5 5 5 5 5 5 5 38 37 39 5 9 9 5 9 1 9 5 5 9 9 9 9 5 5 5 5 1 5 9 1 5 5 5 5 9 5 5 9 5 5 9 9 5 9 9 1 9 9 5 9 5 5 1 9 5 1 5 5 5 306 350 307 308 5 5 5 5 5 5 5 5 9 9 9 8 8 8 36 24 24 24 24 367 33 32 5 5 5 5 5 
5 5 5 5 5 5 5 5 5 5 5 5 5 5 5 5 9 9 9 9 9 1 5 9 9 9 5 5 9 5 5 5 9 5 1 9 9 9 5 9 5 9 9 5 9 1 5 9 5 9 9 9 5 5 5 5 5 5 5 1 9 9 9 9 9 9 5 5 9 9 1 9 9 5 5 5 5 5 5 5 25 26 26 26 36 24 8 3 24 24 3 33 371 32 5 5 5 5 5 5 
5 5 5 5 5 5 5 5 5 5 5 5 5 5 5 5 1 9 9 1 9 9 5 7 7 7 5 5 9 1 9 9 9 5 5 5 5 9 1 9 5 5 9 5 5 9 5 9 5 9 5 9 9 9 9 5 9 5 5 9 5 5 9 5 9 5 5 9 1 9 9 9 1 9 9 5 5 5 25 26 36 24 24 3 24 24 24 24 24 33 31 32 5 5 5 5 5 5 5 5 
5 5 5 5 5 5 5 5 5 5 5 5 5 5 5 5 1 9 9 9 9 9 5 7 7 7 5 5 5 5 5 5 5 5 9 1 9 5 5 9 5 9 9 1 9 9 5 9 9 9 5 5 5 5 9 9 9 9 5 9 1 5 5 9 1 5 5 9 9 9 9 9 1 9 9 5 5 25 36 24 24 3 24 24 8 3 33 31 31 32 9 5 5 5 5 5 5 5 5 5 
5 5 5 5 5 5 5 5 5 5 5 5 5 5 5 5 9 9 9 5 9 9 5 7 7 7 5 9 5 5 1 9 9 9 9 5 9 9 9 1 5 5 5 5 5 5 5 5 5 5 5 5 5 9 1 5 5 9 5 5 9 5 5 9 9 5 5 5 9 9 9 9 9 1 25 26 26 36 24 3 24 24 33 31 8 8 32 9 9 9 1 5 5 5 5 5 5 5 5 5 
5 5 5 5 5 5 5 5 5 5 5 5 5 5 5 5 9 9 9 5 9 1 5 7 7 7 5 9 9 5 9 5 5 5 5 5 9 5 5 9 5 9 5 5 5 5 5 1 9 9 5 9 5 9 5 5 5 1 5 5 9 5 5 1 5 5 5 5 1 9 9 25 26 26 36 24 24 24 33 31 31 31 32 9 8 8 8 9 1 9 5 5 5 5 5 5 5 5 5 5 
5 5 5 5 5 5 5 5 5 5 5 5 5 5 5 5 9 9 9 5 9 9 5 7 7 7 5 9 5 5 9 5 9 5 9 9 1 5 9 9 5 9 5 1 9 9 5 9 25 27 9 414 9 5 5 5 5 9 5 5 9 5 5 9 9 1 5 5 5 25 26 36 24 24 24 3 33 31 32 1 9 9 9 9 8 8 8 9 249 5 5 5 5 5 5 5 5 5 5 5 
5 5 5 5 5 5 5 5 5 5 5 5 5 5 5 5 9 1 9 5 7 7 5 9 9 9 5 1 5 5 9 5 9 9 9 5 5 5 9 5 5 9 5 9 23 9 1 9 30 32 1 413 9 9 9 5 5 9 5 5 9 1 5 5 1 5 5 25 368 36 24 3 24 24 33 31 32 5 5 9 9 9 1 9 8 8 8 1 9 1 5 5 5 5 5 5 5 5 5 301 
5 5 5 5 5 5 5 5 5 5 5 5 5 5 5 5 9 9 1 5 7 7 5 9 1 9 5 9 9 9 1 9 9 5 5 5 5 5 9 1 9 9 5 9 1 9 5 5 5 9 9 9 1 5 9 5 9 1 5 5 5 5 5 1 9 5 25 36 367 24 24 24 3 33 32 5 5 5 5 5 9 5 5 9 9 9 9 9 9 9 249 5 5 5 5 5 5 5 5 304 
5 5 5 5 5 5 5 5 5 5 5 5 5 5 5 5 1 9 9 5 7 7 5 9 9 9 5 5 5 5 9 5 9 5 5 5 5 5 5 5 5 9 9 5 5 5 5 5 5 5 5 5 5 9 1 9 9 5 5 5 9 9 9 9 25 26 36 24 367 24 3 33 31 32 5 5 5 5 5 5 9 5 9 7 7 7 7 7 9 5 9 5 5 5 5 5 5 5 5 304 
5 5 5 5 5 5 5 5 5 5 5 5 5 5 5 5 9 9 9 5 9 9 5 9 9 1 5 5 5 9 9 5 9 9 9 5 9 1 9 9 9 5 5 5 9 9 9 9 5 1 5 5 9 9 5 5 5 5 9 9 9 1 25 26 36 24 24 367 24 33 31 32 9 9 5 5 5 5 5 5 1 9 7 7 7 7 7 7 7 7 1 5 5 5 5 5 5 301 302 312 
5 5 5 5 5 5 5 5 5 5 5 5 5 5 5 5 7 7 7 5 1 9 5 1 9 9 9 9 9 1 5 9 9 5 9 5 9 5 5 5 9 1 9 1 9 5 5 1 5 9 9 1 9 5 5 5 9 9 1 25 26 26 36 24 3 24 33 371 31 32 9 9 9 1 9 5 5 5 5 5 7 7 7 7 7 7 7 7 7 7 7 5 5 5 5 5 5 304 300 300 
5 5 5 5 5 5 5 5 5 5 5 5 5 5 5 5 7 7 7 5 9 9 5 9 9 9 9 9 9 5 5 9 5 5 9 5 5 5 9 9 5 9 9 9 5 5 9 9 5 9 5 5 9 5 5 5 1 9 25 36 24 24 3 24 33 31 32 5 9 9 9 1 9 9 9 5 5 5 5 5 7 7 7 7 7 7 7 7 7 7 7 5 5 5 5 5 5 304 300 300 
5 5 5 5 5 5 5 5 5 5 5 5 5 5 5 5 7 7 7 5 7 7 5 7 7 7 5 5 9 5 9 9 1 9 5 5 5 5 5 9 5 9 9 5 5 5 1 5 5 9 5 5 9 5 5 9 9 25 36 24 24 24 33 31 32 5 5 5 5 9 1 9 9 9 5 5 5 5 5 5 7 7 7 7 7 7 7 7 7 7 7 5 5 5 5 301 302 312 300 300 
5 5 5 5 5 5 5 5 5 5 5 5 5 5 5 5 7 7 7 5 7 7 5 7 7 7 5 5 9 9 5 5 9 5 5 5 9 9 1 9 5 5 1 5 5 9 9 5 5 5 5 5 5 9 9 1 9 28 3 24 33 31 32 5 5 5 5 5 5 5 9 9 9 5 5 5 5 5 5 5 7 7 7 7 7 7 7 7 7 7 5 5 5 5 5 304 300 300 300 300 
5 5 5 5 5 5 5 5 5 5 5 5 5 5 5 5 7 7 7 5 7 7 5 7 7 7 5 5 5 9 5 5 5 5 5 5 9 5 5 9 9 5 9 9 1 9 9 9 9 5 5 5 9 1 5 5 9 30 31 31 32 5 5 5 5 5 5 5 5 5 5 5 5 5 5 5 5 5 5 5 7 7 7 7 7 7 7 9 9 5 5 5 5 5 5 304 300 300 300 300 
5 5 5 5 5 5 5 5 5 5 5 5 5 5 5 5 7 7 7 5 7 7 5 9 1 9 5 5 5 9 9 9 9 9 9 5 1 9 9 5 9 5 9 5 9 9 5 5 1 5 5 9 9 9 9 5 9 1 414 5 5 5 5 5 5 5 5 5 5 5 5 5 5 5 5 5 5 5 5 5 7 7 7 7 9 9 9 9 5 5 5 5 5 5 5 304 300 300 300 300 
5 5 5 5 5 5 5 5 5 5 5 5 5 5 5 5 7 7 7 5 7 7 5 9 9 1 5 5 9 1 5 5 5 9 5 5 5 5 9 5 9 1 9 9 5 9 9 5 9 5 9 1 5 9 5 5 9 5 413 1 5 5 5 5 5 5 5 5 5 5 5 5 5 5 5 5 5 5 5 5 9 9 9 9 9 9 9 249 9 5 5 5 5 5 5 306 310 300 300 300 
5 5 5 5 5 5 5 5 5 5 5 5 5 5 5 5 9 9 1 5 7 7 5 7 7 7 5 5 9 5 5 9 9 9 1 9 9 9 1 9 5 9 5 9 5 5 1 5 9 5 38 39 5 5 9 1 9 9 9 9 5 5 5 5 1 9 5 5 5 5 5 5 5 5 5 5 5 5 5 5 9 9 9 9 9 9 1 9 9 5 5 5 5 5 5 5 306 310 300 300 
5 5 5 5 5 5 5 5 5 5 5 5 5 5 5 5 18 16 19 5 7 7 5 7 7 7 5 5 5 5 9 9 5 5 5 5 5 9 5 5 5 9 5 9 5 5 5 5 9 5 1 9 5 9 414 9 1 9 9 9 1 9 9 9 9 414 5 5 5 5 5 5 5 5 5 5 5 5 5 5 9 9 1 9 18 16 19 5 9 9 249 5 5 5 5 5 5 304 300 300 
5 5 5 5 5 5 5 5 5 5 5 5 5 5 5 5 14 6 13 5 9 9 5 9 1 9 5 5 5 5 5 5 5 5 5 5 5 5 5 5 5 5 5 1 9 9 5 5 9 5 9 1 5 1 413 9 9 9 9 9 9 9 1 9 9 413 1 5 5 5 5 5 5 5 5 5 5 5 5 5 249 9 9 18 17 6 13 9 9 1 9 5 5 5 5 5 5 306 310 300 
5 5 5 5 5 5 5 5 5 5 5 5 5 5 5 5 14 6 13 5 1 9 5 9 9 9 5 5 5 5 5 5 5 5 5 5 5 5 5 9 9 414 9 9 5 1 9 5 9 5 9 5 5 5 1 9 1 9 9 1 9 9 9 1 9 9 5 5 5 5 5 5 5 5 5 5 5 5 5 5 9 1 9 14 6 6 13 9 9 9 9 5 5 5 5 5 5 5 304 300 
5 5 5 5 5 5 5 5 5 5 5 5 5 5 5 5 14 6 13 5 38 39 5 38 37 39 5 5 5 5 5 5 5 62 63 64 65 66 5 5 5 413 5 5 5 5 5 5 9 1 9 5 5 5 5 5 5 1 9 9 9 9 9 5 5 5 5 5 5 5 5 5 5 5 5 5 5 5 5 9 9 9 5 14 6 10 21 9 249 9 9 9 5 5 5 5 5 5 306 310 
5 5 5 5 5 5 5 5 5 5 5 5 5 5 5 5 14 6 13 5 9 9 5 9 9 9 49 50 50 51 9 9 9 67 68 69 70 71 9 5 5 9 9 9 1 9 9 9 9 5 5 5 5 5 5 5 5 5 5 9 1 9 5 5 5 5 5 5 5 5 5 5 5 5 5 5 5 576 577 578 579 580 9 14 6 13 9 9 9 9 1 9 5 5 5 5 5 5 5 304 
5 5 5 5 5 5 5 5 5 5 5 5 1 414 9 5 14 6 15 19 9 1 9 9 9 9 52 53 54 55 9 5 9 72 73 74 75 76 9 1 5 5 5 5 5 5 5 5 5 5 5 5 5 5 5 5 5 5 5 9 9 9 5 5 5 5 5 5 5 5 5 5 5 5 5 5 5 581 582 583 584 585 9 14 6 13 434 435 435 435 436 9 5 5 5 5 5 5 5 304 
5 5 5 5 5 5 5 5 5 5 9 9 9 413 1 9 14 6 6 13 9 9 9 1 9 5 56 57 58 59 9 9 5 77 78 79 80 81 9 9 5 5 5 5 5 5 5 5 5 5 5 5 5 5 5 5 5 5 5 5 9 5 5 5 5 5 5 5 5 5 5 5 5 5 5 9 1 586 587 588 589 590 9 14 6 13 437 438 438 439 440 9 5 5 5 5 5 5 5 304 
5 5 5 5 5 5 5 5 5 9 1 4 9 4 9 4 14 6 6 13 9 9 9 5 9 9 14 6 13 9 9 9 9 1 14 6 13 1 9 9 9 9 44 9 9 9 9 1 5 5 9 9 1 5 9 9 9 1 9 9 9 5 9 1 1 9 9 9 1 1 9 9 9 44 9 9 1 591 592 593 594 595 9 14 6 13 441 442 443 444 445 9 5 5 5 5 5 5 5 304 
5 5 5 5 5 5 5 5 5 9 9 4 1 4 9 4 14 6 6 13 5 9 9 9 1 9 14 6 13 9 9 1 9 9 14 6 13 9 18 16 19 1 43 9 5 18 16 16 16 16 16 16 16 16 16 16 16 16 16 16 16 16 16 16 16 16 16 16 16 16 16 16 19 43 9 9 9 9 14 6 13 18 16 17 6 15 16 19 14 6 13 9 186 187 187 187 188 5 5 304 
5 5 5 5 5 5 5 5 5 5 9 4 9 4 1 4 14 6 6 13 9 1 9 9 9 9 14 6 13 9 1 9 9 9 14 6 13 18 17 6 13 9 43 9 9 14 6 6 6 6 6 6 6 6 6 6 6 6 6 6 6 6 6 6 6 6 6 6 6 6 6 6 13 43 18 16 16 19 14 6 13 14 140 139 139 139 141 13 14 6 13 189 190 191 191 191 192 193 5 306 
5 5 5 5 5 5 5 5 5 5 9 4 9 4 9 4 14 6 6 15 16 16 16 16 16 16 17 6 15 16 16 16 16 16 17 6 15 17 6 6 13 9 45 9 1 20 11 11 11 11 11 11 11 11 11 11 11 11 11 11 11 11 11 11 11 11 11 11 11 11 11 11 21 45 14 6 6 15 17 6 15 17 143 25 26 27 144 15 17 6 15 194 195 196 196 196 197 198 16 16 
5 5 5 5 5 5 5 5 5 5 1 4 1 4 9 4 14 6 6 6 6 6 6 6 6 6 6 6 6 6 6 6 6 6 6 6 6 6 6 10 21 9 5 5 5 5 5 5 5 5 5 5 5 5 5 5 38 37 39 9 1 9 5 5 5 5 5 5 5 5 5 5 5 5 20 12 6 6 6 6 6 6 143 28 3 29 144 6 6 6 6 199 200 201 201 201 202 203 6 6 
5 5 5 5 5 5 5 5 5 5 9 4 9 4 1 4 14 6 6 10 11 11 11 11 11 11 11 11 11 12 6 10 49 50 50 51 11 11 11 21 9 9 7 7 7 7 7 7 7 7 7 7 7 7 7 7 9 9 1 9 9 9 7 7 7 7 7 7 7 7 1 9 9 47 9 20 11 11 12 6 10 12 143 30 31 32 144 10 12 6 10 204 131 206 206 206 135 208 11 11 
5 5 5 5 5 5 5 5 5 5 9 4 9 4 9 4 14 6 6 13 9 9 9 5 9 82 83 84 85 14 6 13 52 53 54 55 9 9 1 9 9 1 7 7 7 7 7 7 7 7 7 7 7 7 7 7 9 1 9 9 9 1 7 7 7 7 7 7 7 7 9 1 9 46 9 9 1 9 14 6 13 14 142 139 139 139 145 13 14 6 13 9 5 5 5 5 5 301 302 302 
5 5 5 5 5 5 5 5 5 9 1 430 416 431 416 432 14 6 6 13 9 9 1 9 9 86 87 88 89 14 6 13 56 57 58 59 9 9 5 9 9 9 7 7 7 7 7 7 7 7 7 7 7 7 7 7 9 9 5 9 1 9 7 7 7 7 7 7 7 7 9 9 9 48 9 9 9 9 20 11 21 20 11 49 50 50 51 21 14 6 13 9 5 5 5 5 5 304 300 300 
5 5 5 5 5 5 5 5 5 9 9 418 419 419 419 420 14 6 6 13 1 5 9 9 5 90 91 92 93 14 6 15 17 6 13 9 5 5 5 5 5 5 5 5 5 5 5 5 5 5 5 5 5 5 5 5 5 5 5 5 9 5 5 5 5 5 5 5 5 5 5 5 5 5 5 9 9 140 139 139 139 141 9 52 53 54 55 9 14 6 13 9 5 5 5 5 5 304 300 300 
5 5 5 5 5 5 5 5 5 9 9 421 422 423 423 424 14 6 6 13 9 9 9 1 9 9 14 6 15 17 6 6 6 6 13 9 5 5 5 5 5 5 5 5 5 5 5 5 5 5 5 5 5 5 5 5 5 5 5 1 9 9 5 5 5 5 5 5 5 5 5 5 5 5 5 5 9 143 22 22 22 144 9 56 57 58 59 9 14 6 13 9 5 5 5 5 5 306 310 300 
5 5 5 5 5 5 5 5 5 9 9 425 426 427 428 429 14 6 10 21 9 1 9 9 9 9 14 6 6 6 6 10 11 11 21 9 5 5 5 5 5 5 5 5 5 5 5 5 5 5 5 5 5 5 5 5 5 5 5 5 9 9 5 5 5 5 5 5 5 5 5 5 5 5 5 5 1 143 22 22 22 144 9 14 6 15 16 16 17 6 13 9 5 5 5 5 5 5 306 310 
5 5 5 5 5 5 5 5 5 5 1 14 6 13 9 9 14 6 13 9 9 9 9 9 1 9 20 11 11 11 11 21 5 9 9 9 5 5 5 5 5 5 5 5 5 5 5 5 5 5 5 5 5 5 5 5 5 5 5 5 5 9 1 5 5 5 5 5 5 5 5 5 5 5 5 5 9 142 139 139 139 145 9 14 6 6 6 6 6 6 13 9 5 5 5 5 5 5 5 304 
5 5 5 5 5 5 5 5 5 5 5 20 11 21 9 9 14 6 13 9 9 9 9 9 9 9 5 5 5 5 5 5 5 5 5 5 5 5 5 5 5 5 5 5 5 5 5 5 5 5 5 5 5 5 5 5 5 5 5 5 5 9 9 9 249 5 5 5 5 5 5 5 5 5 5 5 9 1 9 9 9 9 9 20 11 11 11 11 11 11 21 9 5 5 5 5 5 5 5 304 
5 5 5 5 5 5 5 5 5 5 140 139 139 139 139 139 14 6 13 139 139 139 139 139 139 139 139 139 139 139 139 139 139 139 139 139 141 5 5 5 5 5 5 5 5 5 5 5 5 5 5 5 5 5 5 5 5 5 5 5 5 5 9 9 9 5 5 5 5 5 5 5 5 5 5 5 5 9 9 9 1 9 9 9 1 9 5 5 5 5 5 5 5 5 5 5 5 5 5 304 
5 5 5 5 5 5 5 5 5 5 143 5 5 5 5 9 14 6 13 9 5 5 5 5 5 5 5 5 5 5 5 5 5 5 5 5 144 5 5 5 5 5 5 5 5 5 5 5 5 5 5 5 5 5 5 5 5 5 5 5 5 5 5 9 9 9 5 5 5 5 5 5 5 5 5 5 5 5 5 5 5 5 9 5 5 5 5 5 5 5 5 5 5 5 5 5 5 5 5 304 
5 5 5 5 5 5 5 5 5 5 143 5 5 9 9 9 20 11 21 1 5 5 22 5 23 23 23 5 5 5 5 7 7 5 5 5 144 5 5 5 5 5 5 5 5 5 5 5 5 5 5 5 5 5 5 5 5 5 5 5 5 5 5 5 9 9 9 5 5 5 5 5 5 5 5 5 249 9 9 5 5 9 9 1 5 5 5 5 5 5 5 5 5 5 5 5 5 5 301 312 
5 5 5 5 5 5 5 5 5 5 143 5 9 1 9 22 9 18 16 19 9 9 5 5 1 9 9 5 5 5 7 7 7 7 5 5 144 5 5 5 5 5 5 5 5 5 5 5 5 5 5 5 5 5 5 5 5 5 5 5 5 5 5 5 5 1 9 9 9 9 9 44 1 5 5 9 9 9 1 9 1 9 9 9 5 5 5 5 5 5 5 5 5 5 5 5 5 301 312 300 
5 5 5 5 5 5 5 5 5 5 143 7 7 9 22 9 9 14 6 13 9 9 9 9 9 1 22 9 5 5 7 7 7 7 5 5 144 5 5 5 5 5 5 5 5 5 5 5 5 5 5 5 5 5 5 5 5 5 5 5 5 5 5 5 5 5 9 9 1 9 9 45 9 9 9 9 9 5 5 5 9 9 1 5 5 5 5 5 5 5 5 5 5 5 5 5 5 304 300 300 
5 5 5 5 5 5 5 5 5 5 143 7 7 9 9 9 9 14 6 13 9 1 9 9 5 22 9 9 9 5 7 7 7 7 5 5 144 5 5 5 5 5 5 5 5 5 5 5 5 5 5 5 5 5 5 5 5 5 5 5 5 5 5 5 5 5 5 249 9 9 1 5 5 5 9 1 5 5 5 5 5 5 5 5 5 5 5 5 5 5 5 5 5 5 5 5 301 312 300 300 
5 5 5 5 5 5 5 5 5 5 143 7 7 1 9 1 9 20 11 21 22 9 9 9 9 9 1 9 1 9 9 7 7 1 5 5 144 5 5 5 5 5 5 5 5 5 5 5 5 5 5 5 5 5 5 5 5 5 5 5 5 5 5 5 5 5 5 5 5 5 5 5 5 5 5 5 5 5 5 5 5 5 5 5 5 5 5 5 5 5 5 5 5 5 5 5 304 300 300 300 
5 5 5 5 5 5 5 5 5 5 143 5 9 9 9 18 16 16 19 9 9 22 9 22 9 9 7 7 9 9 9 9 9 1 5 5 144 5 5 5 5 5 5 5 5 5 5 5 5 5 5 5 5 5 5 5 5 5 5 5 5 5 5 5 5 5 5 5 5 5 5 5 5 5 5 5 5 5 5 5 5 5 5 5 5 5 5 5 5 5 5 5 5 5 5 5 304 300 300 300 
5 5 5 5 5 5 5 5 5 5 143 5 5 1 9 14 6 6 13 9 1 9 9 9 9 7 7 7 7 22 1 9 9 22 5 5 144 5 5 5 5 5 5 5 5 5 5 5 5 5 5 5 5 5 5 5 5 5 5 5 5 5 5 5 5 5 5 5 5 5 5 5 5 5 5 5 5 5 5 5 5 5 5 5 5 5 5 5 5 5 5 5 5 5 5 5 304 300 300 300 
5 5 5 5 5 5 5 5 5 5 143 5 5 9 9 14 6 10 21 9 5 5 5 9 9 7 7 7 7 7 9 1 7 5 5 5 144 5 5 5 5 5 5 5 5 5 5 5 5 5 5 5 5 5 5 5 5 5 5 5 5 5 5 5 5 5 5 5 5 5 5 5 5 5 5 5 5 5 5 5 5 5 5 5 5 5 5 5 5 5 5 5 5 5 5 5 304 300 300 300 
5 5 5 5 5 5 5 5 5 5 143 5 5 9 9 20 11 21 9 9 5 5 9 22 9 5 5 5 7 7 7 7 7 5 5 5 144 5 5 5 5 5 5 5 5 5 5 5 5 5 5 5 5 5 5 5 5 5 5 5 5 5 5 5 5 5 5 5 5 5 5 5 5 5 5 5 5 5 5 5 5 5 5 5 5 5 5 5 5 5 5 5 5 5 5 5 304 300 300 300 
5 5 5 5 5 5 5 5 5 5 143 5 5 5 22 1 9 9 1 9 9 5 9 9 5 5 5 5 5 7 7 7 7 5 5 5 144 5 5 5 5 5 5 5 5 5 5 5 5 5 5 5 5 5 5 5 5 5 5 5 5 5 5 5 5 5 5 5 5 5 5 5 5 5 5 5 5 5 5 5 5 5 5 5 5 5 5 5 5 5 5 5 5 5 5 5 304 300 300 300 
5 5 5 5 5 5 5 5 5 5 143 5 5 5 5 5 18 16 19 9 9 1 9 9 7 5 5 5 5 5 5 5 1 9 5 5 144 5 5 5 5 5 5 5 5 5 5 5 5 5 5 5 5 5 5 5 5 5 5 5 5 5 5 5 5 5 5 5 5 5 5 5 5 5 5 5 5 5 5 5 5 5 5 5 5 5 5 5 5 5 5 5 5 5 5 5 5 5 5 5 
5 5 5 5 5 5 5 5 5 5 143 5 5 5 5 5 14 6 13 5 5 5 5 7 7 7 5 5 5 5 5 5 9 9 9 5 144 5 5 5 5 5 5 5 5 5 5 5 5 5 5 5 5 5 5 5 5 5 5 5 5 5 5 5 5 5 5 5 5 5 5 5 5 5 5 5 5 5 5 5 5 5 5 5 5 5 5 5 5 5 5 5 5 5 5 5 5 5 5 5 
5 5 5 5 5 5 5 5 5 5 142 139 139 139 139 139 14 6 13 139 139 139 139 139 139 139 139 139 139 139 139 139 139 1 139 139 145 5 5 5 5 5 5 5 5 5 5 5 5 5 5 5 5 5 5 5 5 5 5 5 5 5 5 5 5 5 5 5 5 5 5 5 5 5 5 5 5 5 5 5 5 5 5 5 5 5 5 5 5 5 5 5 5 5 5 5 5 5 5 5 
5 5 5 5 5 5 5 5 5 5 5 5 5 5 1 9 14 6 13 9 23 23 23 5 5 5 5 5 5 5 5 5 5 9 5 5 5 5 5 5 5 5 5 5 5 5 5 5 5 5 5 5 5 5 5 5 5 5 5 5 5 5 5 5 5 5 5 5 5 5 5 5 5 5 5 5 5 5 5 5 5 5 5 5 5 5 5 5 5 5 5 5 5 5 5 5 5 5 5 5 
5 5 5 5 5 5 5 5 5 5 5 5 5 5 9 9 14 6 13 9 9 1 9 5 5 5 5 5 5 5 5 5 5 9 5 5 5 5 5 5 5 5 5 5 5 5 5 5 5 5 5 5 5 5 5 5 5 5 5 5 5 5 5 5 5 5 5 5 5 5 5 5 5 5 5 5 5 5 5 5 5 5 5 5 5 5 5 5 5 5 5 5 5 5 5 5 5 5 5 5 
5 5 5 5 5 5 5 5 5 5 5 5 5 5 9 1 14 6 13 9 1 9 5 5 5 5 5 5 5 5 5 1 9 9 1 9 1 5 5 5 5 5 5 5 5 5 5 5 5 5 5 5 5 5 5 5 5 5 5 5 5 5 5 5 5 5 5 5 5 5 5 5 5 5 5 5 5 5 5 5 5 5 5 5 5 5 5 5 5 5 5 5 5 5 5 5 5 5 5 5 
5 5 5 5 5 5 5 5 5 5 5 5 5 5 5 9 14 6 13 9 5 5 5 5 5 5 5 5 5 5 5 5 5 1 9 5 5 5 5 5 5 5 5 5 5 5 5 5 5 5 5 5 5 5 5 5 5 5 5 5 5 5 5 5 5 5 5 5 5 5 5 5 5 5 5 5 5 5 5 5 5 5 5 5 5 5 5 5 5 5 5 5 5 5 5 5 5 5 5 5 
5 5 5 5 5 5 5 5 5 5 5 5 5 5 5 5 114 115 116 5 5 5 5 5 5 5 5 5 5 5 5 5 5 237 238 239 5 5 5 5 5 5 5 5 5 5 5 5 5 5 5 5 5 5 5 5 5 5 5 5 5 5 5 5 5 5 5 5 5 5 5 5 5 5 5 5 5 5 5 5 5 5 5 5 5 5 5 5 5 5 5 5 5 5 5 5 5 5 5 5 
5 5 5 5 5 5 5 5 5 5 5 5 5 5 5 186 117 118 119 188 5 5 5 5 5 5 5 5 5 5 5 5 237 248 236 247 239 5 5 5 5 5 5 5 5 5 5 5 5 5 5 5 5 5 5 5 5 5 5 5 5 5 5 5 5 5 5 5 5 5 5 5 5 5 5 5 5 5 5 5 5 5 5 5 5 5 5 5 5 5 5 5 5 5 5 5 5 5 5 5 
5 5 5 5 5 5 5 5 5 5 5 5 5 5 5 190 191 191 191 192 5 5 5 5 5 5 5 5 5 5 5 237 248 236 236 236 241 5 5 5 5 5 5 5 5 5 5 5 5 5 5 5 5 5 5 5 5 5 5 5 5 5 5 5 5 5 5 5 5 5 5 5 5 5 5 5 5 5 5 5 5 5 5 5 5 5 5 5 5 5 5 5 5 5 5 5 5 5 5 5 
5 5 5 5 5 5 5 5 5 5 5 5 5 5 5 195 196 196 196 197 5 5 5 5 5 5 5 5 5 5 5 240 236 236 236 236 241 5 5 5 5 5 5 5 5 5 5 5 5 5 5 5 5 5 5 5 5 5 5 5 5 5 5 5 5 5 5 5 5 5 5 5 5 5 5 5 5 5 5 5 5 5 5 5 5 5 5 5 5 5 5 5 5 5 5 5 5 5 5 5 
5 5 5 5 5 5 5 5 5 5 5 5 5 5 5 126 127 128 129 130 5 5 5 5 5 5 5 5 5 5 5 240 236 236 236 236 241 5 5 5 5 5 5 5 5 5 5 5 5 5 5 5 5 5 5 5 5 5 5 5 5 5 5 5 5 5 5 5 5 5 5 5 5 5 5 5 5 5 5 5 5 5 5 5 5 5 5 5 5 5 5 5 5 5 5 5 5 5 5 5 
5 5 5 5 5 5 5 5 5 5 5 5 5 5 5 131 132 133 134 135 5 5 5 5 5 5 5 5 5 5 5 242 246 236 236 245 244 5 5 5 5 5 5 5 5 5 5 5 5 5 5 5 5 5 5 5 5 5 5 5 5 5 5 5 5 5 5 5 5 5 5 5 5 5 5 5 5 5 5 5 5 5 5 5 5 5 5 5 5 5 5 5 5 5 5 5 5 5 5 5 
5 5 5 5 5 5 5 5 5 5 5 5 5 5 9 9 136 137 138 5 5 5 5 5 5 5 5 5 5 5 5 5 242 243 243 244 5 5 5 5 5 5 5 5 5 5 5 5 5 5 5 5 5 5 5 5 5 5 5 5 5 5 5 5 5 5 5 5 5 5 5 5 5 5 5 5 5 5 5 5 5 5 5 5 5 5 5 5 5 5 5 5 5 5 5 5 5 5 5 5 
5 5 5 5 5 5 5 5 5 5 5 5 5 9 9 9 14 6 13 9 9 9 5 5 5 5 5 5 5 5 5 5 5 5 5 5 5 5 5 5 5 5 5 5 5 5 5 5 5 5 5 5 5 5 5 5 5 5 5 5 5 5 5 5 5 5 5 5 5 5 5 5 5 5 5 5 5 5 5 5 5 5 5 5 5 5 5 5 5 5 5 5 5 5 5 5 5 5 5 5 
5 5 5 5 5 5 5 5 5 5 5 5 9 9 9 9 14 6 13 9 9 9 9 5 5 5 5 5 5 5 5 5 5 5 5 5 5 5 5 5 5 5 5 5 5 5 5 5 5 5 5 5 5 5 5 5 5 5 5 5 5 5 5 5 5 5 5 5 5 5 5 5 5 5 5 5 5 5 5 5 5 5 5 5 5 5 5 5 5 5 5 5 5 5 5 5 5 5 5 5 
5 5 5 5 5 5 5 5 5 5 5 5 9 9 9 9 14 6 13 9 9 9 9 5 5 5 5 5 5 5 5 5 5 5 5 5 5 5 5 5 5 5 5 5 5 5 5 5 5 5 5 5 5 5 5 5 5 5 5 5 5 5 5 5 5 5 5 5 5 5 5 5 5 5 5 5 5 5 5 5 5 5 5 5 5 5 5 5 5 5 5 5 5 5 5 5 5 5 5 5 
5 5 5 5 5 5 5 5 5 5 5 5 5 5 5 5 5 5 5 5 5 5 5 5 5 5 5 5 5 5 5 5 5 5 5 5 5 5 5 5 5 5 5 5 5 5 5 5 5 5 5 5 5 5 5 5 5 5 5 5 5 5 5 5 5 5 5 5 5 5 5 5 5 5 5 5 5 5 5 5 5 5 5 5 5 5 5 5 5 5 5 5 5 5 5 5 5 5 5 5 
5 5 5 5 5 5 5 5 5 5 5 5 5 5 5 5 5 5 5 5 5 5 5 5 5 5 5 5 5 5 5 5 5 5 5 5 5 5 5 5 5 5 5 5 5 5 5 5 5 5 5 5 5 5 5 5 5 5 5 5 5 5 5 5 5 5 5 5 5 5 5 5 5 5 5 5 5 5 5 5 5 5 5 5 5 5 5 5 5 5 5 5 5 5 5 5 5 5 5 5 
5 5 5 5 5 5 5 5 5 5 5 5 5 5 5 5 5 5 5 5 5 5 5 5 5 5 5 5 5 5 5 5 5 5 5 5 5 5 5 5 5 5 5 5 5 5 5 5 5 5 5 5 5 5 5 5 5 5 5 5 5 5 5 5 5 5 5 5 5 5 5 5 5 5 5 5 5 5 5 5 5 5 5 5 5 5 5 5 5 5 5 5 5 5 5 5 5 5 5 5 
5 5 5 5 5 5 5 5 5 5 5 5 5 5 5 5 5 5 5 5 5 5 5 5 5 5 5 5 5 5 5 5 5 5 5 5 5 5 5 5 5 5 5 5 5 5 5 5 5 5 5 5 5 5 5 5 5 5 5 5 5 5 5 5 5 5 5 5 5 5 5 5 5 5 5 5 5 5 5 5 5 5 5 5 5 5 5 5 5 5 5 5 5 5 5 5 5 5 5 5 
5 5 5 5 5 5 5 5 5 5 5 5 5 5 5 5 5 5 5 5 5 5 5 5 5 5 5 5 5 5 5 5 5 5 5 5 5 5 5 5 5 5 5 5 5 5 5 5 5 5 5 5 5 5 5 5 5 5 5 5 5 5 5 5 5 5 5 5 5 5 5 5 5 5 5 5 5 5 5 5 5 5 5 5 5 5 5 5 5 5 5 5 5 5 5 5 5 5 5 5 
5 5 5 5 5 5 5 5 5 5 5 5 5 5 5 5 5 5 5 5 5 5 5 5 5 5 5 5 5 5 5 5 5 5 5 5 5 5 5 5 5 5 5 5 5 5 5 5 5 5 5 5 5 5 5 5 5 5 5 5 5 5 5 5 5 5 5 5 5 5 5 5 5 5 5 5 5 5 5 5 5 5 5 5 5 5 5 5 5 5 5 5 5 5 5 5 5 5 5 5 
5 5 5 5 5 5 5 5 5 5 5 5 5 5 5 5 5 5 5 5 5 5 5 5 5 5 5 5 5 5 5 5 5 5 5 5 5 5 5 5 5 5 5 5 5 5 5 5 5 5 5 5 5 5 5 5 5 5 5 5 5 5 5 5 5 5 5 5 5 5 5 5 5 5 5 5 5 5 5 5 5 5 5 5 5 5 5 5 5 5 5 5 5 5 5 5 5 5 5 5 
5 5 5 5 5 5 5 5 5 5 5 5 5 5 5 5 5 5 5 5 5 5 5 5 5 5 5 5 5 5 5 5 5 5 5 5 5 5 5 5 5 5 5 5 5 5 5 5 5 5 5 5 5 5 5 5 5 5 5 5 5 5 5 5 5 5 5 5 5 5 5 5 5 5 5 5 5 5 5 5 5 5 5 5 5 5 5 5 5 5 5 5 5 5 5 5 5 5 5 5 
5 5 5 5 5 5 5 5 5 5 5 5 5 5 5 5 5 5 5 5 5 5 5 5 5 5 5 5 5 5 5 5 5 5 5 5 5 5 5 5 5 5 5 5 5 5 5 5 5 5 5 5 5 5 5 5 5 5 5 5 5 5 5 5 5 5 5 5 5 5 5 5 5 5 5 5 5 5 5 5 5 5 5 5 5 5 5 5 5 5 5 5 5 5 5 5 5 5 5 5 
5 5 5 5 5 5 5 5 5 5 5 5 5 5 5 5 5 5 5 5 5 5 5 5 5 5 5 5 5 5 5 5 5 5 5 5 5 5 5 5 5 5 5 5 5 5 5 5 5 5 5 5 5 5 5 5 5 5 5 5 5 5 5 5 5 5 5 5 5 5 5 5 5 5 5 5 5 5 5 5 5 5 5 5 5 5 5 5 5 5 5 5 5 5 5 5 5 5 5 5 
5 5 5 5 5 5 5 5 5 5 5 5 5 5 5 5 5 5 5 5 5 5 5 5 5 5 5 5 5 5 5 5 5 5 5 5 5 5 5 5 5 5 5 5 5 5 5 5 5 5 5 5 5 5 5 5 5 5 5 5 5 5 5 5 5 5 5 5 5 5 5 5 5 5 5 5 5 5 5 5 5 5 5 5 5 5 5 5 5 5 5 5 5 5 5 5 5 5 5 5 
5 5 5 5 5 5 5 5 5 5 5 5 5 5 5 5 5 5 5 5 5 5 5 5 5 5 5 5 5 5 5 5 5 5 5 5 5 5 5 5 5 5 5 5 5 5 5 5 5 5 5 5 5 5 5 5 5 5 5 5 5 5 5 5 5 5 5 5 5 5 5 5 5 5 5 5 5 5 5 5 5 5 5 5 5 5 5 5 5 5 5 5 5 5 5 5 5 5 5 5 
5 5 5 5 5 5 5 5 5 5 5 5 5 5 5 5 5 5 5 5 5 5 5 5 5 5 5 5 5 5 5 5 5 5 5 5 5 5 5 5 5 5 5 5 5 5 5 5 5 5 5 5 5 5 5 5 5 5 5 5 5 5 5 5 5 5 5 5 5 5 5 5 5 5 5 5 5 5 5 5 5 5 5 5 5 5 5 5 5 5 5 5 5 5 5 5 5 5 5 5 
