5 5 5 5 5 5 5 5 5 5 5 253 258 261 263 258 258 261 263 261 263 258 258 258 258 258 261 251 262 258 258 258 258 258 258 258 258 264 262 258 258 264 262 264 262 256 5 5 301 300 300 300 300 305 5 5 5 5 5 5 5 5 5 5 5 5 5 5 5 5 5 5 5 5 5 5 5 5 5 5 5 5 5 5 5 5 5 5 5 5 5 5 5 5 5 5 5 5 5 5 
5 5 5 5 5 5 5 5 5 5 5 5 5 253 258 258 261 263 261 263 258 258 258 258 258 261 263 258 264 262 258 258 258 258 258 258 258 258 264 262 258 258 264 262 256 5 5 301 312 300 300 300 300 305 5 5 5 5 5 5 5 5 5 5 5 5 5 5 5 5 5 5 5 5 5 5 5 5 5 5 5 5 5 5 5 5 5 5 5 5 5 5 5 5 5 5 5 5 5 5 
5 5 5 5 5 5 5 5 5 5 5 5 5 5 5 5 253 261 263 258 258 258 258 258 261 263 258 258 261 252 262 258 258 258 258 258 258 258 258 264 262 258 258 256 5 5 301 312 300 300 300 300 309 308 5 5 5 5 5 5 5 5 5 5 5 5 5 5 5 5 5 5 5 5 5 5 5 5 5 5 5 5 5 5 5 5 5 5 5 5 5 5 5 5 5 5 5 5 5 5 
5 5 5 5 5 5 5 5 5 5 5 5 5 5 5 5 5 253 258 258 258 258 258 261 263 258 258 261 263 264 252 262 258 258 258 258 258 258 258 258 256 5 5 5 5 5 304 300 300 300 300 300 305 5 5 5 5 5 5 5 5 5 5 5 5 5 5 5 5 5 5 5 5 5 5 5 5 5 5 5 5 5 5 5 5 5 5 5 5 5 5 5 5 5 5 5 5 5 5 5 
5 5 5 5 5 5 5 5 5 5 5 5 5 5 5 5 5 5 5 5 5 5 5 253 258 258 261 263 258 258 264 252 5 5 301 302 302 302 302 303 5 5 5 5 5 5 304 300 300 300 300 309 308 5 5 5 5 5 5 5 5 5 5 5 5 5 5 5 5 5 5 5 5 5 5 5 5 5 5 5 5 5 5 5 5 5 5 5 5 5 5 5 5 5 5 5 5 5 5 5 
5 5 5 5 5 5 5 5 5 5 5 5 5 5 5 5 5 5 5 5 5 5 5 301 302 303 253 259 258 258 258 256 301 302 312 300 309 307 310 311 303 5 5 5 5 5 304 300 300 300 300 305 5 5 5 5 5 5 5 5 5 5 5 5 5 5 5 5 5 5 5 5 5 5 5 5 5 5 5 5 5 5 5 5 5 5 5 5 5 5 5 5 5 5 5 5 5 5 5 5 
5 5 5 5 5 5 5 5 5 5 5 5 5 5 5 5 5 5 5 5 5 5 5 304 300 305 1 9 9 301 302 302 312 300 300 300 305 9 304 300 311 303 5 5 5 301 312 300 309 307 307 308 5 5 5 5 5 5 5 5 5 5 5 5 5 5 5 5 5 5 5 5 5 5 5 576 577 578 579 580 5 5 5 5 5 5 5 5 5 5 5 5 5 5 5 5 5 5 5 5 
5 5 5 5 5 5 5 5 5 5 5 5 5 5 5 5 5 301 302 303 5 5 5 304 300 305 9 301 302 312 309 307 310 300 300 300 311 302 312 300 300 311 302 302 302 312 300 309 308 5 5 5 5 5 5 5 301 303 5 5 5 5 5 5 5 5 5 5 5 5 5 5 5 5 5 581 582 583 584 585 5 5 5 5 5 5 5 5 5 5 5 5 5 5 5 5 5 5 5 5 
5 5 5 5 5 5 5 5 5 5 5 5 5 5 5 5 5 304 300 311 303 5 301 312 309 308 9 306 310 300 350 9 304 300 309 307 307 310 300 300 300 300 300 300 300 300 300 305 5 5 5 9 1 9 5 301 312 311 302 303 5 5 5 5 5 5 301 303 5 5 5 5 5 5 5 586 587 588 589 590 9 5 5 5 5 5 5 5 5 5 5 5 5 5 5 5 5 5 5 5 
5 5 5 5 5 5 5 5 5 5 5 5 5 5 5 5 5 304 300 300 311 302 312 300 305 9 9 9 306 310 350 302 312 300 305 9 9 304 300 300 300 309 307 310 300 300 300 305 5 5 9 9 7 7 5 306 310 300 309 308 7 7 7 7 301 302 312 311 303 5 5 5 5 5 9 591 592 593 594 595 9 1 5 5 5 5 5 5 5 5 5 5 5 5 5 5 5 5 5 5 
5 5 5 5 5 5 5 5 5 5 5 5 5 5 5 5 5 304 300 300 300 309 310 309 308 9 9 1 9 306 350 310 300 300 311 302 302 312 300 300 300 305 9 304 300 300 300 305 5 5 1 7 7 7 5 5 306 307 308 9 7 7 7 7 304 300 300 300 305 1 9 9 9 5 18 16 17 6 13 9 5 9 9 5 5 5 5 5 5 5 5 5 5 5 5 5 5 5 5 5 
5 5 5 5 5 5 5 5 5 5 5 5 5 5 5 5 5 304 300 300 300 311 312 305 7 7 7 7 7 7 7 306 310 300 300 300 300 300 300 300 300 311 302 312 300 300 309 308 5 5 7 7 7 7 5 5 5 5 9 1 9 9 9 9 306 310 300 309 308 5 1 9 18 16 17 6 6 6 13 9 9 9 1 5 5 5 5 5 5 5 5 5 5 5 5 5 5 5 5 5 
5 5 5 5 5 5 5 5 5 5 5 5 5 5 5 5 5 306 310 300 300 300 309 308 5 7 7 7 7 7 7 7 306 310 300 300 300 300 309 307 307 310 300 300 300 300 305 5 5 5 5 7 7 7 5 9 9 1 9 9 5 5 9 1 9 306 307 308 9 9 5 18 17 6 6 6 10 11 21 9 1 9 5 5 5 5 5 5 1 5 9 5 5 5 5 5 5 5 5 5 
5 5 5 5 5 5 5 5 5 5 5 5 5 5 5 5 5 5 304 300 300 300 305 5 5 7 7 7 7 7 7 7 7 306 307 310 300 300 305 9 1 304 300 300 300 300 305 5 5 5 18 16 16 16 16 16 16 16 19 5 5 5 5 9 9 9 1 9 9 18 16 17 6 6 10 11 21 9 9 9 5 5 5 5 5 5 5 5 5 249 1 5 9 5 5 5 5 5 5 5 
5 5 5 5 5 5 5 5 5 5 5 5 5 5 5 5 5 5 306 307 310 309 308 5 5 5 7 7 7 7 7 7 7 5 5 306 310 300 311 303 9 304 300 300 300 309 308 5 18 16 17 6 6 6 6 6 6 6 15 16 16 16 16 16 19 9 9 18 16 17 6 6 6 10 21 9 9 1 5 5 5 5 5 5 5 5 5 5 9 5 9 9 5 1 5 5 5 5 5 5 
5 5 5 5 5 5 5 5 5 5 5 5 5 5 5 5 5 5 5 5 304 305 9 9 5 5 5 7 7 7 7 7 7 7 5 5 306 310 300 311 302 312 300 300 309 308 5 18 17 6 6 6 10 11 11 11 12 6 6 6 6 6 6 6 15 16 16 17 6 6 6 10 11 21 9 1 9 5 5 5 301 302 302 303 5 5 5 747 748 749 5 5 5 5 5 5 5 5 5 5 
5 5 5 5 5 5 5 5 5 5 5 5 5 5 5 5 5 5 5 9 306 308 9 9 9 5 5 5 7 7 7 7 7 7 5 5 5 306 310 300 300 300 300 309 308 9 18 17 6 6 10 11 21 9 9 1 20 11 11 11 11 11 12 6 6 6 6 6 6 10 11 21 9 1 9 9 5 5 301 302 312 300 300 311 303 5 5 750 751 752 5 1 5 5 5 5 5 5 5 5 
5 5 5 5 5 5 5 5 5 5 5 5 5 5 5 5 5 5 9 9 9 9 9 1 9 9 5 5 5 7 7 7 7 7 7 5 5 5 306 307 307 307 307 308 18 16 17 6 6 10 21 9 1 9 9 9 9 9 1 9 9 9 20 11 11 11 11 11 11 21 5 9 9 9 9 5 5 301 312 300 300 300 300 300 305 5 1 753 754 755 5 5 5 5 5 5 5 5 5 5 
5 5 5 5 5 5 5 5 5 5 5 5 5 5 5 5 5 5 9 1 9 9 9 9 9 9 9 9 9 9 9 9 9 1 9 5 5 5 5 5 5 18 16 16 17 6 6 6 10 21 9 9 9 9 5 9 9 9 9 9 9 1 9 7 7 9 9 9 5 5 5 5 9 9 1 5 5 304 300 300 300 300 300 309 308 5 9 1 9 9 9 5 1 5 5 5 5 5 5 5 
5 5 5 5 5 5 5 5 5 5 5 5 5 5 5 5 5 5 9 9 9 9 9 9 1 9 9 9 9 9 1 9 9 9 9 9 9 9 9 18 16 17 6 6 6 6 10 11 21 9 1 9 5 5 301 303 5 5 5 9 9 9 7 7 7 7 7 7 5 5 5 5 5 1 9 9 301 312 300 300 300 300 300 305 5 9 9 9 9 1 9 9 5 1 5 5 5 5 5 5 
5 5 5 5 5 5 5 5 5 5 5 5 5 5 5 5 5 9 9 9 5 9 9 9 9 9 9 9 9 9 9 9 9 1 9 9 9 1 18 17 6 6 6 10 11 11 21 9 9 9 5 5 5 301 312 311 303 5 5 9 1 7 7 1 7 7 7 5 9 5 5 5 5 9 9 1 306 310 300 300 300 300 309 308 5 1 9 9 9 9 9 9 5 249 5 5 5 5 5 5 
5 5 5 5 5 5 5 5 5 5 5 5 5 5 5 5 5 9 1 5 5 5 9 9 9 5 5 5 9 9 9 9 9 5 5 5 5 5 20 12 6 10 11 21 1 9 9 1 9 5 5 5 301 312 300 300 305 5 5 9 7 7 9 7 7 9 7 7 9 5 9 5 5 1 5 9 9 306 307 310 300 309 308 5 5 9 9 9 9 5 249 9 5 5 5 5 5 5 5 5 
5 5 5 5 5 5 5 5 5 5 5 5 5 5 5 5 5 9 9 9 5 5 9 9 5 5 5 5 9 9 1 9 5 5 5 5 5 9 9 20 11 21 9 9 5 1 9 301 350 302 302 302 312 300 300 300 305 5 5 1 9 7 7 9 7 7 7 9 1 9 9 5 5 9 9 5 9 1 9 306 307 308 5 5 5 249 9 1 5 5 9 1 5 5 5 5 5 5 5 5 
5 5 5 5 5 5 5 5 5 5 5 5 5 5 5 5 5 9 9 9 9 9 9 9 5 5 5 5 9 9 9 9 5 5 5 5 5 9 9 1 9 9 9 5 5 5 301 312 350 300 300 300 300 300 300 309 308 5 5 9 7 7 7 7 7 7 7 9 7 1 5 5 5 5 1 9 9 140 139 139 139 139 139 139 139 139 9 141 5 5 5 5 5 5 5 5 5 5 5 5 
5 5 5 5 5 5 5 5 5 5 5 5 5 5 5 5 5 9 9 9 9 9 9 5 5 5 5 9 9 9 9 9 5 5 5 9 9 9 9 9 9 1 5 5 5 5 304 300 350 350 350 300 300 300 309 308 5 5 5 5 7 9 7 7 7 5 7 7 9 5 5 5 5 5 5 5 5 143 1 9 5 7 7 7 18 19 9 144 5 5 5 5 5 5 5 5 5 5 5 5 
5 5 5 5 5 5 5 5 5 5 5 5 5 5 5 5 5 9 9 9 9 9 9 5 5 5 5 9 1 9 9 9 5 5 5 9 9 7 7 7 7 7 5 5 5 5 306 310 300 300 350 300 300 309 308 5 5 7 7 9 7 7 7 5 9 1 9 5 5 5 1 5 9 7 5 5 5 143 9 1 9 7 7 7 20 21 1 144 5 5 5 5 5 5 5 5 5 5 5 5 
5 5 5 5 5 5 5 5 5 5 5 5 5 5 5 5 5 9 9 1 9 5 5 5 5 5 9 9 9 9 9 9 5 5 5 9 9 7 7 7 7 7 5 5 5 5 5 306 310 309 350 307 307 308 5 5 5 7 5 7 7 9 1 7 7 9 5 5 5 7 7 5 7 5 5 5 5 143 5 1 9 7 7 7 9 1 9 144 5 5 5 5 5 5 5 5 5 5 5 5 
5 5 5 5 5 5 5 5 5 5 5 5 5 5 5 5 5 7 7 7 7 5 5 9 9 9 9 9 9 9 1 9 9 5 5 9 9 7 7 7 7 7 9 5 5 5 5 5 306 308 9 9 5 5 5 5 7 7 7 9 1 7 9 1 5 5 7 5 5 5 5 5 5 7 9 5 5 143 7 7 7 9 1 9 7 7 7 144 5 5 5 5 5 5 5 5 5 5 5 5 
5 5 5 5 5 5 5 5 5 5 5 5 5 5 5 5 5 7 7 7 7 5 9 9 1 9 9 9 9 9 9 9 9 5 5 9 1 7 7 7 7 7 1 414 5 5 5 5 5 5 9 1 5 5 5 7 7 7 1 9 7 9 7 5 5 5 5 5 9 7 9 1 5 5 9 5 5 143 7 7 7 1 9 9 7 7 7 144 5 5 5 5 5 5 5 5 5 5 5 5 
5 5 5 5 5 5 5 5 5 5 5 5 5 5 5 5 5 7 7 7 7 5 9 9 9 9 9 9 9 9 9 9 5 5 5 9 9 7 7 7 7 7 9 413 5 5 5 5 5 1 9 9 5 5 5 5 5 5 5 5 5 7 1 5 5 5 1 7 1 5 5 7 5 5 5 5 5 143 7 7 7 9 9 1 7 7 7 144 5 5 5 5 5 5 5 5 5 5 5 5 
5 5 5 5 5 5 5 5 5 5 5 5 5 5 5 5 5 7 7 7 7 301 303 9 18 16 16 16 19 9 9 9 5 5 5 9 9 7 7 7 7 7 9 9 5 5 5 5 5 9 1 5 5 5 5 7 5 5 1 5 5 9 7 9 7 9 1 5 9 7 9 9 5 5 9 5 5 143 1 18 19 7 7 7 18 16 19 144 5 5 5 5 5 5 5 5 5 5 5 5 
5 5 5 5 5 5 5 5 5 5 5 5 5 5 5 5 5 7 7 7 7 304 305 9 14 6 6 6 13 1 9 5 5 5 5 301 303 7 7 7 7 7 1 5 5 5 5 5 5 5 9 5 5 5 5 5 5 5 5 7 5 5 9 5 5 5 5 5 7 7 5 5 5 5 7 5 5 143 18 17 13 7 7 7 14 6 13 144 5 5 5 5 5 5 5 5 5 5 5 5 
5 5 5 5 5 5 5 5 5 5 5 5 5 5 5 5 5 7 7 7 301 312 305 9 14 6 6 6 13 9 9 5 5 5 5 304 311 302 302 8 303 5 5 5 5 5 5 5 5 1 9 5 5 5 5 5 5 7 7 5 5 5 7 1 5 5 5 7 5 9 1 5 5 5 5 5 5 143 20 11 21 7 7 7 20 11 21 144 5 5 5 5 5 5 5 5 5 5 5 5 
5 5 5 5 5 5 5 5 5 5 5 5 5 5 5 5 5 7 7 301 312 309 308 5 14 6 6 6 13 9 5 5 5 5 5 304 300 309 310 8 311 303 5 5 5 5 5 5 5 9 1 5 5 5 5 5 5 5 1 5 5 5 5 9 9 7 5 5 5 7 414 5 9 5 5 5 5 142 139 139 139 18 16 19 139 139 139 145 5 5 5 5 5 5 5 5 5 5 5 5 
5 5 5 5 5 5 5 5 5 5 5 5 5 5 5 5 5 9 9 304 300 305 5 5 14 6 6 6 13 9 5 5 5 5 5 306 310 311 312 8 300 311 303 5 5 5 5 5 5 9 9 5 5 5 5 5 5 5 5 5 5 9 5 5 1 9 5 5 5 9 413 9 5 1 9 5 5 5 5 5 5 14 6 13 5 5 5 5 5 5 5 5 5 5 5 5 5 5 5 5 
5 5 5 5 5 5 5 5 5 5 5 5 5 5 5 5 5 9 9 304 300 305 5 5 14 6 6 6 13 9 9 5 5 5 7 9 306 310 300 309 310 300 305 5 5 5 5 5 9 1 9 5 5 5 5 5 5 5 5 5 5 7 5 5 5 9 7 9 5 1 9 9 5 9 7 1 9 5 5 5 18 17 10 21 5 5 5 5 5 5 5 5 5 5 5 5 5 5 5 5 
5 5 5 5 5 5 5 5 5 5 5 5 5 5 5 5 5 1 9 306 310 311 303 5 14 6 6 6 13 9 9 7 7 7 7 7 9 304 300 305 306 310 305 5 5 5 5 5 1 9 5 5 5 5 5 5 5 5 5 1 7 5 5 5 5 5 5 1 9 7 7 7 7 7 9 9 1 9 9 18 17 6 13 5 5 5 5 5 5 5 5 5 5 5 5 5 5 5 5 5 
5 5 5 5 5 5 5 5 5 5 5 5 5 5 5 5 5 9 9 9 304 300 305 5 14 6 6 6 13 9 9 7 7 7 7 7 1 304 300 311 302 312 305 5 5 5 5 5 9 9 5 5 5 5 5 5 5 5 7 5 5 5 5 1 5 5 5 5 5 7 7 7 7 7 7 7 9 7 1 20 11 11 21 5 5 5 5 5 5 5 5 5 5 5 5 5 5 5 5 5 
5 5 5 5 5 5 5 5 5 5 5 5 5 5 5 5 5 9 9 9 304 300 305 9 14 6 6 6 13 1 9 7 7 7 7 7 9 304 300 300 300 300 305 5 5 5 5 22 9 1 5 5 5 5 5 5 5 5 1 5 5 5 9 5 5 5 5 5 5 5 5 5 5 5 5 5 5 5 5 5 5 5 5 5 5 5 5 5 5 5 5 5 5 5 5 5 5 5 5 5 
5 5 5 5 5 5 5 5 5 5 5 5 5 5 5 5 5 1 9 9 304 300 305 1 14 6 6 6 13 9 9 9 7 7 7 9 301 312 300 309 310 300 305 5 5 5 5 9 1 9 5 5 5 5 5 5 5 5 5 5 5 5 5 5 5 5 5 5 5 5 5 5 5 5 5 5 5 5 5 5 5 5 5 5 5 5 5 5 5 5 5 5 5 5 5 5 5 5 5 5 
5 5 5 5 5 5 5 5 5 5 5 5 5 5 5 5 5 9 9 9 304 300 305 9 14 6 6 6 13 9 9 9 7 7 9 301 312 300 300 311 312 309 308 5 5 5 9 9 9 1 5 5 5 5 5 5 5 5 5 5 5 5 5 5 5 5 5 5 5 5 5 5 5 5 5 5 5 5 5 5 5 5 5 5 5 5 5 5 5 5 5 5 5 5 5 5 5 5 5 5 
5 5 5 5 5 5 5 5 5 5 5 5 5 5 5 5 5 9 9 9 306 310 305 9 14 6 6 6 13 9 9 9 1 9 301 312 309 310 300 300 300 305 5 5 5 9 1 9 9 22 5 5 5 5 5 5 5 5 5 5 5 5 5 5 5 5 5 5 5 5 5 5 5 5 5 5 5 5 5 5 5 5 5 5 5 5 5 5 5 5 5 5 5 5 5 5 5 5 5 5 
5 5 5 5 5 5 5 5 5 5 5 5 5 5 5 5 5 9 1 9 5 306 308 9 14 6 6 6 13 9 1 9 9 9 304 300 311 312 309 307 307 308 5 5 5 9 9 9 9 5 5 5 5 5 5 5 5 5 5 5 5 5 5 5 5 5 5 5 5 5 5 5 5 5 5 5 5 5 5 5 5 5 5 5 5 5 5 5 5 5 5 5 5 5 5 5 5 5 5 5 
5 5 5 5 5 5 5 5 5 5 5 5 5 5 5 5 5 9 9 9 5 5 5 9 14 6 6 6 13 9 9 9 9 301 312 300 300 309 308 5 5 5 5 5 22 9 9 9 9 5 5 5 5 5 5 5 5 5 5 5 5 5 5 5 5 5 5 5 5 5 5 5 5 5 5 5 5 5 5 5 5 5 5 5 5 5 5 5 5 5 5 5 5 5 5 5 5 5 5 5 
5 5 5 5 5 5 5 5 5 5 5 5 5 5 5 5 5 9 9 9 5 5 9 9 14 6 6 6 13 9 1 9 301 312 309 307 307 308 5 5 5 5 5 5 9 9 4 9 1 5 5 5 5 5 5 5 5 5 5 5 5 5 5 5 5 5 5 5 5 5 5 5 5 5 5 5 5 5 5 5 5 5 5 5 5 5 5 5 5 5 5 5 5 5 5 5 5 5 5 5 
5 5 5 5 5 5 5 5 5 5 5 5 5 5 5 5 9 1 9 9 9 5 9 9 14 6 6 6 13 9 9 301 312 309 308 5 5 5 5 5 5 5 5 5 1 9 9 9 22 5 5 5 5 5 5 5 5 5 5 5 5 5 5 5 5 5 5 5 5 5 5 5 5 5 5 5 5 5 5 5 5 5 5 5 5 5 5 5 5 5 5 5 5 5 5 5 5 5 5 5 
5 5 5 5 5 5 5 5 5 5 5 5 5 5 5 414 1 9 9 9 5 5 9 9 14 6 6 6 13 9 9 306 307 308 5 5 5 5 5 5 5 5 5 5 5 22 9 1 5 5 5 5 5 5 5 5 5 5 5 5 5 5 5 5 5 5 5 5 5 5 5 5 5 5 5 5 5 5 5 5 5 5 5 5 5 5 5 5 5 5 5 5 5 5 5 5 5 5 5 5 
5 5 5 5 5 5 5 5 5 5 5 5 5 5 5 413 9 9 9 9 9 5 5 9 14 6 6 6 13 1 9 5 5 5 5 5 5 5 5 5 5 5 5 5 5 5 5 5 5 5 5 5 5 5 5 5 5 5 5 5 5 5 5 5 5 5 5 5 5 5 5 5 5 5 5 5 5 5 5 5 5 5 5 5 5 5 5 5 5 5 5 5 5 5 5 5 5 5 5 5 
5 5 5 5 5 5 5 5 5 5 5 5 5 5 5 5 5 9 1 9 9 5 5 9 14 6 6 6 13 9 5 5 5 5 5 5 5 5 5 5 5 5 5 5 5 5 5 5 5 5 5 5 5 5 5 5 5 5 5 5 5 5 5 5 5 5 5 5 5 5 5 5 5 5 5 5 5 5 5 5 5 5 5 5 5 5 5 5 5 5 5 5 5 5 5 5 5 5 5 5 
5 5 5 5 5 5 5 5 5 5 5 5 5 5 5 5 5 5 5 5 5 5 5 9 20 11 11 11 21 9 5 5 5 5 5 5 5 5 5 5 5 5 5 5 5 5 5 5 5 5 5 5 5 5 5 5 5 5 5 5 5 5 5 5 5 5 5 5 5 5 5 5 5 5 5 5 5 5 5 5 5 5 5 5 5 5 5 5 5 5 5 5 5 5 5 5 5 5 5 5 
5 5 5 5 5 5 5 5 5 5 5 5 5 5 5 5 5 5 5 5 5 5 5 5 9 1 9 9 9 5 5 5 5 5 5 5 5 5 5 5 5 5 5 5 5 5 5 5 5 5 5 5 5 5 5 5 5 5 5 5 5 5 5 5 5 5 5 5 5 5 5 5 5 5 5 5 5 5 5 5 5 5 5 5 5 5 5 5 5 5 5 5 5 5 5 5 5 5 5 5 
5 5 5 5 5 5 5 5 5 5 5 5 5 5 5 5 5 5 5 5 5 5 5 5 9 9 9 9 9 5 5 5 5 5 5 5 5 5 5 5 5 5 5 5 5 5 5 5 5 5 5 5 5 5 5 5 5 5 5 5 5 5 5 5 5 5 5 5 5 5 5 5 5 5 5 5 5 5 5 5 5 5 5 5 5 5 5 5 5 5 5 5 5 5 5 5 5 5 5 5 
5 5 5 5 5 5 5 5 5 5 5 5 165 166 166 166 166 167 5 5 5 5 5 5 9 8 8 8 9 5 5 5 5 5 5 5 5 5 5 5 5 5 5 5 5 5 5 5 5 5 5 5 5 5 5 5 5 5 5 5 5 5 5 5 5 5 5 5 5 5 5 5 5 5 5 5 5 5 5 5 5 5 5 5 5 5 5 5 5 5 5 5 5 5 5 5 5 5 5 5 
5 5 5 5 5 5 5 5 5 5 9 9 168 169 169 169 169 170 9 9 9 9 44 9 9 8 8 8 9 9 9 9 9 9 44 9 9 9 9 9 9 1 9 9 146 147 147 147 147 147 148 9 9 5 5 5 5 5 5 5 5 5 5 5 5 5 5 5 5 5 5 5 5 5 5 5 5 5 5 5 5 5 5 5 5 5 5 5 5 5 5 5 5 5 5 5 5 5 5 5 
5 5 5 5 5 5 5 5 5 5 1 9 171 172 172 172 172 173 9 9 9 1 43 9 9 8 8 8 9 9 9 1 9 9 43 9 9 9 1 9 9 9 9 9 149 150 150 150 150 150 151 9 9 5 5 5 5 5 5 5 5 5 5 5 5 5 5 5 5 5 5 5 5 5 5 5 5 5 5 5 5 5 5 5 5 5 5 5 5 5 5 5 5 5 5 5 5 5 5 5 
5 5 5 5 5 5 5 5 5 5 9 9 174 175 176 177 178 179 9 1 9 9 43 9 9 8 8 8 9 9 9 9 9 9 43 9 9 9 9 1 9 9 9 9 149 150 150 150 150 150 151 9 9 5 5 5 5 5 5 5 5 5 5 5 5 5 5 5 5 5 5 5 5 5 5 5 5 5 5 5 5 5 5 5 5 5 5 5 5 5 5 5 5 5 5 5 5 5 5 5 
5 5 5 5 5 5 5 5 5 5 9 9 180 181 182 183 184 185 9 9 9 9 45 9 9 8 8 8 9 9 9 9 9 9 45 9 9 9 9 9 9 9 9 9 152 156 156 153 154 155 157 9 1 5 5 5 5 5 5 5 5 5 5 5 5 5 5 5 5 5 5 5 5 5 5 5 5 5 5 5 5 5 5 5 5 5 5 5 5 5 5 5 5 5 5 5 5 5 5 5 
5 5 5 5 5 5 5 5 5 5 9 9 9 9 8 8 8 8 8 8 8 8 8 8 8 8 8 8 8 8 8 8 8 8 8 8 8 8 8 8 9 9 1 9 158 162 163 159 183 161 164 9 9 5 5 5 5 5 5 5 5 5 5 5 5 5 5 5 5 5 5 5 5 5 5 5 5 5 5 5 5 5 5 5 5 5 5 5 5 5 5 5 5 5 5 5 5 5 5 5 
5 5 5 5 5 5 5 5 5 5 9 9 9 9 8 8 8 8 8 8 8 8 8 8 8 8 8 8 8 8 8 8 8 8 8 8 8 8 8 8 9 9 9 9 9 9 9 8 8 8 9 9 9 5 5 5 5 5 5 5 5 5 5 5 5 5 5 5 5 5 5 5 5 5 5 5 5 5 5 5 5 5 5 5 5 5 5 5 5 5 5 5 5 5 5 5 5 5 5 5 
5 5 5 5 5 5 5 5 5 5 9 1 9 9 8 8 8 8 8 8 8 8 8 8 8 8 8 8 8 8 8 8 8 8 8 8 8 8 8 8 8 8 8 8 8 8 8 8 8 8 9 1 9 5 5 5 5 5 5 5 5 5 5 5 5 5 5 5 5 5 5 5 5 5 5 5 5 5 5 5 5 5 5 5 5 5 5 5 5 5 5 5 5 5 5 5 5 5 5 5 
5 5 5 5 5 5 5 5 5 5 9 9 9 9 8 8 8 9 9 9 9 9 44 9 9 209 210 210 210 211 212 9 9 9 44 9 9 8 8 8 8 8 8 8 8 8 8 8 8 8 9 9 9 5 5 5 5 5 5 5 5 5 5 5 5 5 5 5 5 5 5 5 5 5 5 5 5 5 5 5 5 5 5 5 5 5 5 5 5 5 5 5 5 5 5 5 5 5 5 5 
5 5 5 5 5 5 5 5 5 5 9 9 9 9 8 8 8 9 9 9 1 9 43 9 9 213 214 214 214 215 216 9 9 1 43 1 9 8 8 8 8 8 8 8 8 8 8 8 8 8 9 9 1 5 5 5 5 5 5 5 5 5 5 5 5 5 5 5 5 5 5 5 5 5 5 5 5 5 5 5 5 5 5 5 5 5 5 5 5 5 5 5 5 5 5 5 5 5 5 5 
5 5 5 5 5 5 5 5 5 5 9 9 9 9 8 8 8 9 9 9 9 9 43 1 9 217 218 219 218 219 220 9 9 9 43 9 9 8 8 8 9 9 9 1 9 9 9 9 9 9 9 9 9 5 5 5 5 5 5 5 5 5 5 5 5 5 5 5 5 5 5 5 5 5 5 5 5 5 5 5 5 5 5 5 5 5 5 5 5 5 5 5 5 5 5 5 5 5 5 5 
5 5 5 5 5 5 5 5 5 5 9 1 9 9 8 8 8 9 1 9 9 9 43 9 9 221 222 223 230 231 224 9 9 9 43 9 9 8 8 8 9 9 9 9 9 9 9 9 9 9 9 9 9 5 5 5 5 5 5 5 5 5 5 5 5 5 5 5 5 5 5 5 5 5 5 5 5 5 5 5 5 5 5 5 5 5 5 5 5 5 5 5 5 5 5 5 5 5 5 5 
5 5 5 5 5 5 5 5 209 210 211 212 9 9 8 8 8 9 9 9 1 9 43 9 9 225 183 227 233 234 228 1 9 9 43 9 1 8 8 8 9 9 9 9 9 9 9 9 9 9 1 9 9 5 5 5 5 5 5 5 5 5 5 5 5 5 5 5 5 5 5 5 5 5 5 5 5 5 5 5 5 5 5 5 5 5 5 5 5 5 5 5 5 5 5 5 5 5 5 5 
5 5 5 5 5 5 5 5 213 214 215 216 9 1 8 8 8 9 9 9 9 9 45 9 9 20 11 21 9 9 9 9 9 9 45 9 9 8 8 8 9 9 9 9 9 9 9 9 9 9 9 9 9 5 5 5 5 5 5 5 5 5 5 5 5 5 5 5 5 5 5 5 5 5 5 5 5 5 5 5 5 5 5 5 5 5 5 5 5 5 5 5 5 5 5 5 5 5 5 5 
5 5 5 5 5 5 5 5 217 218 219 220 9 9 8 8 8 9 9 25 26 26 26 26 26 26 26 26 26 26 26 26 26 26 26 26 26 8 8 8 26 26 26 26 26 26 26 26 26 26 26 26 26 26 26 26 26 26 26 26 26 26 368 26 26 26 26 26 26 26 26 26 26 26 26 26 26 26 26 26 26 26 26 26 26 26 26 26 26 26 26 26 26 26 26 26 26 26 26 26 
5 5 5 5 5 5 5 5 229 230 231 224 26 26 8 8 8 26 26 36 24 24 24 24 24 24 24 24 24 24 24 24 24 24 24 24 24 8 8 8 24 24 24 24 3 24 24 24 24 3 24 24 24 24 24 24 24 24 24 3 24 24 367 24 24 24 24 24 24 24 24 3 24 24 24 24 24 24 24 24 3 24 24 24 24 24 3 24 24 24 24 24 24 24 3 24 24 24 24 24 
5 5 5 5 5 5 5 5 229 230 231 224 3 24 8 8 8 24 24 24 24 24 24 3 24 24 24 24 24 24 24 24 24 3 24 24 24 8 8 8 24 24 24 24 24 24 24 3 24 24 24 24 24 24 24 3 24 24 24 24 24 24 24 367 24 24 24 3 24 24 24 24 24 3 24 24 24 24 3 24 24 24 24 24 3 24 24 24 24 24 24 3 24 24 24 24 24 24 24 3 
5 5 5 5 5 5 5 5 229 230 231 224 31 31 8 8 8 31 31 34 24 24 24 24 24 24 24 24 3 24 24 24 24 24 24 24 24 8 8 8 24 24 24 3 24 24 24 24 24 24 24 3 24 24 24 24 24 24 24 24 24 3 24 24 367 24 24 24 3 24 24 24 24 24 24 3 24 24 24 24 24 3 24 24 24 24 24 24 3 24 24 24 24 24 24 24 3 24 24 24 
5 5 5 5 5 5 5 5 229 230 231 224 9 9 8 8 8 9 9 30 31 31 31 31 31 31 31 31 31 31 34 3 33 31 31 31 31 8 8 8 31 31 31 31 31 31 31 31 31 31 31 31 31 31 31 31 31 31 31 31 31 31 31 31 371 31 31 31 31 31 31 31 31 31 31 31 31 31 31 31 31 31 31 31 31 31 31 31 31 31 31 31 31 31 31 31 31 31 31 31 
5 5 5 5 5 5 5 5 232 233 234 228 9 9 8 8 8 9 9 9 1 9 44 9 9 44 9 140 9 9 28 24 29 9 9 141 9 8 8 8 9 9 9 9 9 9 1 9 9 9 140 9 209 210 211 212 9 141 9 9 5 5 5 5 5 5 5 5 5 5 5 5 5 5 5 5 5 5 5 5 5 5 5 5 5 5 5 5 5 5 5 5 5 5 5 5 5 5 5 5 
5 5 5 5 5 5 5 5 5 5 9 9 1 9 8 8 8 9 9 9 9 9 43 9 1 43 9 143 1 9 28 24 29 9 9 144 1 8 8 8 9 9 1 9 9 9 9 9 9 9 143 9 213 214 215 216 9 144 9 9 5 5 5 5 5 5 5 5 5 5 5 5 5 5 5 5 5 5 5 5 5 5 5 5 5 5 5 5 5 5 5 5 5 5 5 5 5 5 5 5 
5 5 5 5 5 5 5 5 5 5 9 9 9 9 8 8 8 9 1 9 9 9 43 9 9 43 9 143 9 9 28 24 29 9 1 144 9 8 8 8 9 9 9 49 50 50 51 9 9 9 143 9 217 218 219 220 9 144 9 1 5 5 5 5 5 5 5 5 5 5 5 5 5 5 5 5 5 5 5 5 5 5 5 5 5 5 5 5 5 5 5 5 5 5 5 5 5 5 5 5 
5 5 5 5 5 5 5 5 5 5 9 9 9 9 8 8 8 9 9 9 9 9 43 9 9 43 9 143 9 1 28 3 29 1 9 144 9 8 8 8 1 9 9 52 53 54 55 9 9 1 143 9 221 222 223 224 9 144 9 9 5 5 5 5 5 5 5 5 5 5 5 5 5 5 5 5 5 5 5 5 5 5 5 5 5 5 5 5 5 5 5 5 5 5 5 5 5 5 5 5 
5 5 5 5 5 5 5 5 5 5 9 1 9 9 8 8 8 9 1 9 9 9 43 1 9 43 9 143 9 9 30 31 32 9 9 144 9 8 8 8 9 1 9 56 57 58 59 9 9 9 143 9 225 226 227 228 9 144 1 9 5 5 5 5 5 5 5 5 5 5 5 5 5 5 5 5 5 5 5 5 5 5 5 5 5 5 5 5 5 5 5 5 5 5 5 5 5 5 5 5 
5 5 5 5 5 5 5 5 5 5 9 9 1 9 8 8 8 9 9 9 1 9 43 9 1 43 9 142 139 139 139 139 139 139 139 145 1 8 8 8 9 9 9 8 8 8 9 9 9 9 143 9 20 11 21 9 9 144 9 9 5 5 5 5 5 5 5 5 5 5 5 5 5 5 5 5 5 5 5 5 5 5 5 5 5 5 5 5 5 5 5 5 5 5 5 5 5 5 5 5 
5 5 5 5 5 5 5 5 5 5 9 9 9 9 8 8 8 9 9 9 9 9 45 9 9 45 9 9 1 9 9 9 1 9 9 9 9 8 8 8 9 9 9 8 8 8 9 9 9 9 142 139 139 139 139 139 139 145 9 9 5 5 5 5 5 5 5 5 5 5 5 5 5 5 5 5 5 5 5 5 5 5 5 5 5 5 5 5 5 5 5 5 5 5 5 5 5 5 5 5 
5 5 5 5 5 5 5 5 5 5 1 9 9 9 8 8 8 8 8 8 8 8 8 8 8 8 8 8 8 8 8 8 8 8 8 8 8 8 8 8 8 8 8 8 8 8 8 8 8 9 9 9 9 9 9 9 9 9 1 9 5 5 5 5 5 5 5 5 5 5 5 5 5 5 5 5 5 5 5 5 5 5 5 5 5 5 5 5 5 5 5 5 5 5 5 5 5 5 5 5 
5 5 5 5 5 5 5 5 5 5 1 9 9 9 8 8 8 8 8 8 8 8 8 8 8 8 8 8 8 8 8 8 8 8 8 8 8 8 8 8 8 8 8 8 8 8 8 8 8 9 9 9 9 9 1 9 9 9 9 9 5 5 5 5 5 5 5 5 5 5 5 5 5 5 5 5 5 5 5 5 5 5 5 5 5 5 5 5 5 5 5 5 5 5 5 5 5 5 5 5 
5 5 5 5 5 5 5 5 5 5 9 9 1 9 8 8 8 8 8 8 8 8 8 8 8 8 8 8 8 8 8 8 8 8 8 8 8 8 8 8 8 8 8 8 8 8 8 8 8 1 9 1 9 9 9 9 9 9 9 9 5 5 5 5 5 5 5 5 5 5 5 5 5 5 5 5 5 5 5 5 5 5 5 5 5 5 5 5 5 5 5 5 5 5 5 5 5 5 5 5 
5 5 5 5 5 5 5 5 5 5 9 9 9 9 9 8 8 9 209 210 211 212 44 9 9 44 9 8 8 8 9 9 9 1 44 9 9 9 9 1 9 9 9 8 8 8 9 9 9 9 9 9 9 9 9 9 9 1 9 9 5 5 5 5 5 5 5 5 5 5 5 5 5 5 5 5 5 5 5 5 5 5 5 5 5 5 5 5 5 5 5 5 5 5 5 5 5 5 5 5 
5 5 5 5 5 5 5 5 5 5 9 1 9 9 9 8 8 9 213 214 215 216 43 9 1 43 9 8 8 8 1 9 9 9 43 9 62 63 64 65 66 9 9 8 8 8 9 9 9 9 9 9 9 9 9 9 9 9 9 9 5 5 5 5 5 5 5 5 5 5 5 5 5 5 5 5 5 5 5 5 5 5 5 5 5 5 5 5 5 5 5 5 5 5 5 5 5 5 5 5 
5 5 5 5 5 5 5 5 5 5 82 83 84 85 9 8 8 9 217 218 219 220 43 9 9 43 9 8 8 8 9 9 1 9 43 9 67 68 69 70 71 9 9 8 8 8 9 9 49 50 50 51 9 9 9 9 9 9 9 9 5 5 5 5 5 5 5 5 5 5 5 5 5 5 5 5 5 5 5 5 5 5 5 5 5 5 5 5 5 5 5 5 5 5 5 5 5 5 5 5 
5 5 5 5 5 5 5 5 5 5 86 87 88 89 9 8 8 9 221 222 223 224 43 1 9 43 9 8 8 8 9 9 9 9 43 9 72 73 74 75 76 9 1 8 8 8 9 9 52 53 54 55 9 9 9 9 1 9 9 9 5 5 5 5 5 5 5 5 5 5 5 5 5 5 5 5 5 5 5 5 5 5 5 5 5 5 5 5 5 5 5 5 5 5 5 5 5 5 5 5 
5 5 5 5 5 5 5 5 5 5 90 91 92 93 9 8 8 9 225 79 227 228 43 9 9 43 9 8 8 8 9 9 9 9 43 9 77 78 79 80 81 9 9 8 8 8 9 9 56 57 58 59 9 9 9 9 9 9 9 9 5 5 5 5 5 5 5 5 5 5 5 5 5 5 5 5 5 5 5 5 5 5 5 5 5 5 5 5 5 5 5 5 5 5 5 5 5 5 5 5 
5 5 5 5 5 5 5 5 5 5 9 8 8 9 1 8 8 9 9 8 8 9 43 9 9 43 9 8 8 8 9 9 9 9 43 9 9 8 8 8 9 9 9 8 8 8 9 1 9 8 8 9 9 9 9 9 9 9 9 9 5 5 5 5 5 5 5 5 5 5 5 5 5 5 5 5 5 5 5 5 5 5 5 5 5 5 5 5 5 5 5 5 5 5 5 5 5 5 5 5 
5 5 5 5 5 5 5 5 5 5 9 8 8 8 8 8 8 8 8 8 8 9 43 9 9 43 9 8 8 8 9 1 9 9 43 1 9 8 8 8 8 8 8 8 8 8 8 8 8 8 8 9 9 9 9 1 9 9 9 1 5 5 5 5 5 5 5 5 5 5 5 5 5 5 5 5 5 5 5 5 5 5 5 5 5 5 5 5 5 5 5 5 5 5 5 5 5 5 5 5 
5 5 5 5 5 5 5 5 5 5 1 8 8 8 8 8 8 8 8 8 8 9 43 9 1 43 9 8 8 8 9 9 9 1 43 9 9 8 8 8 8 8 8 8 8 8 8 8 8 8 8 9 9 9 9 9 9 9 9 9 5 5 5 5 5 5 5 5 5 5 5 5 5 5 5 5 5 5 5 5 5 5 5 5 5 5 5 5 5 5 5 5 5 5 5 5 5 5 5 5 
5 5 5 5 5 5 5 5 5 5 9 9 9 9 9 9 1 9 9 9 9 9 45 9 9 45 9 8 8 8 9 9 9 9 45 9 9 9 1 9 9 9 9 9 9 9 9 9 9 9 9 9 1 9 9 9 9 9 9 9 5 5 5 5 5 5 5 5 5 5 5 5 5 5 5 5 5 5 5 5 5 5 5 5 5 5 5 5 5 5 5 5 5 5 5 5 5 5 5 5 
5 5 5 5 5 5 5 5 5 5 5 5 5 5 5 5 5 5 5 5 5 5 5 5 5 5 186 117 118 119 188 5 5 5 5 5 5 5 5 5 5 5 5 5 5 5 5 5 5 5 5 5 5 5 5 5 5 5 5 5 5 5 5 5 5 5 5 5 5 5 5 5 5 5 5 5 5 5 5 5 5 5 5 5 5 5 5 5 5 5 5 5 5 5 5 5 5 5 5 5 
5 5 5 5 5 5 5 5 5 5 5 5 5 5 5 5 5 5 5 5 5 5 5 5 5 5 190 191 191 191 192 5 5 5 5 5 5 5 5 5 5 5 5 5 5 5 5 5 5 5 5 5 5 5 5 5 5 5 5 5 5 5 5 5 5 5 5 5 5 5 5 5 5 5 5 5 5 5 5 5 5 5 5 5 5 5 5 5 5 5 5 5 5 5 5 5 5 5 5 5 
5 5 5 5 5 5 5 5 5 5 5 5 5 5 5 5 5 5 5 5 5 5 5 5 5 5 195 196 196 196 197 5 5 5 5 5 5 5 5 5 5 5 5 5 5 5 5 5 5 5 5 5 5 5 5 5 5 5 5 5 5 5 5 5 5 5 5 5 5 5 5 5 5 5 5 5 5 5 5 5 5 5 5 5 5 5 5 5 5 5 5 5 5 5 5 5 5 5 5 5 
5 5 5 5 5 5 5 5 5 5 5 5 5 5 5 5 5 5 5 5 5 5 5 5 5 5 126 127 128 129 130 5 5 5 5 5 5 5 5 5 5 5 5 5 5 5 5 5 5 5 5 5 5 5 5 5 5 5 5 5 5 5 5 5 5 5 5 5 5 5 5 5 5 5 5 5 5 5 5 5 5 5 5 5 5 5 5 5 5 5 5 5 5 5 5 5 5 5 5 5 
5 5 5 5 5 5 5 5 5 5 5 5 5 5 5 5 5 5 5 5 5 5 5 5 5 5 131 132 133 134 135 5 5 5 5 5 5 5 5 5 5 5 5 5 5 5 5 5 5 5 5 5 5 5 5 5 5 5 5 5 5 5 5 5 5 5 5 5 5 5 5 5 5 5 5 5 5 5 5 5 5 5 5 5 5 5 5 5 5 5 5 5 5 5 5 5 5 5 5 5 
5 5 5 5 5 5 5 5 5 5 5 5 5 5 5 5 5 5 5 5 5 5 5 5 5 5 5 136 137 138 5 5 5 5 5 5 5 5 5 5 5 5 5 5 5 5 5 5 5 5 5 5 5 5 5 5 5 5 5 5 5 5 5 5 5 5 5 5 5 5 5 5 5 5 5 5 5 5 5 5 5 5 5 5 5 5 5 5 5 5 5 5 5 5 5 5 5 5 5 5 
5 5 5 5 5 5 5 5 5 5 5 5 5 5 5 5 5 5 5 5 5 5 5 5 5 5 5 14 6 13 5 5 5 5 5 5 5 5 5 5 5 5 5 5 5 5 5 5 5 5 5 5 5 5 5 5 5 5 5 5 5 5 5 5 5 5 5 5 5 5 5 5 5 5 5 5 5 5 5 5 5 5 5 5 5 5 5 5 5 5 5 5 5 5 5 5 5 5 5 5 
5 5 5 5 5 5 5 5 5 5 5 5 5 5 5 5 5 5 5 5 5 5 5 5 5 5 5 5 5 5 5 5 5 5 5 5 5 5 5 5 5 5 5 5 5 5 5 5 5 5 5 5 5 5 5 5 5 5 5 5 5 5 5 5 5 5 5 5 5 5 5 5 5 5 5 5 5 5 5 5 5 5 5 5 5 5 5 5 5 5 5 5 5 5 5 5 5 5 5 5 
5 5 5 5 5 5 5 5 5 5 5 5 5 5 5 5 5 5 5 5 5 5 5 5 5 5 5 5 5 5 5 5 5 5 5 5 5 5 5 5 5 5 5 5 5 5 5 5 5 5 5 5 5 5 5 5 5 5 5 5 5 5 5 5 5 5 5 5 5 5 5 5 5 5 5 5 5 5 5 5 5 5 5 5 5 5 5 5 5 5 5 5 5 5 5 5 5 5 5 5 
5 5 5 5 5 5 5 5 5 5 5 5 5 5 5 5 5 5 5 5 5 5 5 5 5 5 5 5 5 5 5 5 5 5 5 5 5 5 5 5 5 5 5 5 5 5 5 5 5 5 5 5 5 5 5 5 5 5 5 5 5 5 5 5 5 5 5 5 5 5 5 5 5 5 5 5 5 5 5 5 5 5 5 5 5 5 5 5 5 5 5 5 5 5 5 5 5 5 5 5 
