5 5 5 5 5 5 5 5 5 5 5 5 5 5 5 5 5 5 5 5 5 5 5 5 5 5 5 5 5 5 5 5 5 5 5 5 5 5 5 5 5 5 5 5 5 5 5 5 5 5 5 5 5 5 5 5 5 5 5 5 5 5 5 5 5 5 5 5 5 5 5 5 5 5 5 5 5 5 5 5 5 5 5 5 5 5 5 5 5 5 5 5 5 5 5 5 5 5 5 304 
5 5 5 5 5 5 5 5 5 5 5 5 5 5 5 5 5 5 5 5 5 5 5 5 5 5 5 5 5 5 5 5 5 5 5 5 5 5 5 5 5 5 5 5 5 5 5 5 5 5 5 5 5 5 5 5 5 5 5 5 5 5 5 5 5 5 5 5 5 5 5 5 5 5 5 5 5 5 5 5 5 5 5 5 5 5 5 5 5 5 5 5 5 5 5 5 5 5 5 304 
5 5 5 5 5 5 5 5 5 5 5 5 5 5 5 5 5 5 5 5 5 5 5 5 5 5 5 5 5 5 5 5 5 5 5 5 5 5 5 5 5 5 5 5 5 5 5 5 5 5 5 5 5 5 5 5 5 5 5 5 5 5 5 5 5 5 5 5 5 5 5 5 5 5 5 5 5 5 5 5 5 5 5 5 5 5 5 5 5 5 5 5 5 5 5 5 5 5 5 304 
5 5 5 5 5 5 5 5 5 5 5 5 5 5 5 5 5 5 5 5 5 5 5 5 5 5 5 5 5 5 5 5 5 5 5 5 5 5 5 5 5 5 5 5 5 5 5 5 5 5 5 5 5 5 5 5 5 5 5 5 5 5 5 5 5 5 5 5 5 5 5 5 5 5 5 5 5 5 5 5 5 5 5 5 5 5 5 5 5 5 5 5 5 5 5 5 5 5 5 304 
5 5 5 5 5 5 5 5 5 5 5 5 5 5 5 5 5 5 5 5 5 5 5 5 5 5 5 5 5 5 5 5 5 5 5 5 5 5 5 5 5 5 5 5 5 5 5 5 5 5 5 5 5 5 5 5 5 5 5 5 5 5 5 5 5 5 5 5 5 5 5 5 5 5 5 5 5 5 5 5 5 5 5 5 5 5 5 5 5 5 5 5 5 5 5 5 5 5 5 304 
5 5 5 5 5 5 5 5 5 5 5 5 5 5 5 5 5 5 5 5 5 5 5 5 5 5 5 5 5 5 5 5 5 5 5 5 5 5 5 5 5 5 5 5 5 5 5 5 5 5 5 5 5 5 5 5 5 5 5 5 5 5 5 5 5 5 5 5 5 5 5 5 5 5 5 5 5 5 5 5 5 5 5 5 5 5 5 5 5 5 5 5 5 5 5 5 5 5 5 304 
5 5 5 5 5 5 5 5 5 5 5 5 5 5 5 5 5 5 5 5 5 5 5 5 5 5 5 5 5 5 5 5 5 5 5 5 5 5 5 5 5 5 5 5 5 5 5 5 5 5 5 5 5 5 5 5 5 5 5 5 5 5 5 5 5 5 5 5 5 5 5 5 5 5 5 5 5 5 5 5 5 5 5 5 5 5 5 5 5 5 5 5 5 5 5 5 5 5 5 304 
5 5 5 5 5 5 5 5 5 5 5 5 5 5 5 5 5 5 5 5 5 5 5 5 5 5 5 5 5 5 5 5 5 5 5 5 5 5 5 5 5 5 5 5 5 5 5 5 5 5 5 5 5 5 5 5 5 5 5 5 5 5 5 5 5 5 5 5 5 5 5 5 5 5 5 5 5 5 5 5 5 5 5 5 5 5 5 5 5 5 5 5 5 5 5 5 5 5 5 304 
5 5 5 5 5 5 5 5 5 5 5 5 5 5 5 5 5 5 5 5 5 5 5 5 5 5 5 5 5 5 5 5 5 5 5 5 5 5 5 5 5 5 5 5 5 5 5 5 5 5 5 5 5 5 5 5 5 5 5 5 5 5 5 5 5 5 5 5 5 5 5 5 5 5 5 5 5 5 5 5 5 5 5 5 5 5 5 5 5 5 5 5 5 5 5 5 5 5 5 304 
5 5 5 5 5 5 5 5 5 5 5 5 5 5 5 5 5 5 5 5 5 5 5 5 5 5 5 5 5 5 5 5 5 5 5 5 5 5 5 5 5 5 5 5 5 5 5 5 5 5 5 5 5 5 5 5 5 5 5 5 5 5 5 5 5 5 5 5 5 5 5 5 5 5 5 5 5 5 5 5 5 5 5 5 5 5 5 5 5 5 5 5 5 5 5 5 5 5 5 304 
5 5 5 5 5 5 5 5 5 5 5 5 5 5 5 5 5 5 5 5 5 5 5 5 5 5 5 5 5 5 5 5 5 5 5 5 5 5 5 5 5 5 5 5 5 5 5 5 5 5 5 5 5 5 5 5 5 5 5 5 5 5 5 5 5 5 5 5 5 5 5 5 5 5 5 5 5 9 5 5 5 5 5 5 5 5 5 5 5 5 5 5 5 5 5 5 5 5 5 304 
5 5 5 5 5 5 5 5 5 5 5 5 5 5 5 5 5 5 5 5 5 5 5 5 5 5 5 5 5 5 5 5 5 5 5 5 5 5 5 5 5 5 5 5 5 5 5 5 5 5 5 5 5 5 5 5 5 5 5 5 5 5 5 5 5 5 5 5 5 5 5 9 5 5 5 5 5 5 5 5 5 5 5 5 5 5 5 5 5 5 5 5 5 5 5 5 5 5 5 304 
5 5 5 5 5 5 5 5 5 5 5 5 5 5 5 5 5 5 5 5 5 5 5 5 5 5 5 5 5 5 5 5 5 5 5 5 5 5 5 5 5 5 5 5 5 5 5 5 5 5 5 5 5 5 5 5 5 5 5 5 5 5 5 5 5 5 5 5 5 1 5 9 5 249 5 1 5 5 1 249 5 5 5 5 5 5 5 5 5 5 5 5 5 5 5 5 5 5 5 304 
5 5 5 5 5 5 5 5 5 5 5 5 5 5 5 5 5 5 5 5 5 5 5 5 5 5 5 5 5 5 5 5 5 5 5 5 5 5 5 5 5 5 5 5 5 5 5 5 5 5 5 5 5 5 5 5 5 5 5 5 5 5 5 5 5 5 5 5 9 5 5 9 9 5 5 5 5 9 9 9 5 5 5 5 5 5 5 5 5 5 5 5 5 5 5 5 5 5 5 304 
5 5 5 5 5 5 5 5 5 5 5 5 5 5 5 5 5 5 5 5 5 5 5 5 5 5 5 5 5 5 5 5 5 5 5 5 5 5 5 5 5 5 5 5 5 5 5 5 5 5 5 5 5 5 5 5 5 5 5 5 5 5 5 5 5 5 5 5 9 249 1 9 9 1 9 9 9 1 9 5 5 5 5 5 5 5 5 5 5 5 5 5 5 5 5 5 5 5 5 304 
5 5 5 5 5 5 5 5 5 5 5 5 5 5 5 5 5 5 5 5 5 5 5 5 5 5 5 5 5 5 5 5 5 5 5 5 5 5 5 5 5 5 5 5 5 5 5 5 5 5 5 5 5 5 5 5 5 5 5 5 5 5 5 5 5 5 5 1 5 5 9 1 9 5 5 5 5 249 5 5 9 5 5 5 249 5 5 5 5 5 5 5 5 5 5 5 5 5 5 304 
5 5 5 5 5 5 5 5 5 5 5 5 5 5 5 5 5 5 5 5 5 5 5 5 5 5 5 5 5 5 5 5 5 5 5 5 5 5 5 5 5 5 5 5 5 5 5 5 5 5 5 5 5 5 5 5 5 5 5 5 5 5 5 5 5 5 5 5 5 5 5 9 5 5 5 5 5 5 5 5 5 5 770 5 5 5 5 5 5 5 5 5 5 5 5 5 5 5 5 304 
5 5 5 5 5 5 5 5 5 5 5 5 5 5 5 5 5 5 5 5 5 5 5 5 5 5 5 5 5 5 5 5 5 5 5 5 5 5 5 5 5 5 5 5 5 5 5 5 5 5 5 5 5 5 5 5 5 5 5 5 5 5 5 5 5 5 5 9 1 9 9 1 9 9 9 9 5 9 1 414 249 771 772 5 5 5 5 5 5 5 5 5 5 5 5 5 5 5 5 304 
5 5 5 5 5 5 5 5 5 5 5 5 5 5 5 5 5 5 5 5 5 5 5 5 5 5 5 5 5 5 5 5 5 5 5 5 5 5 5 5 5 5 5 5 5 5 5 5 5 5 5 5 5 5 5 5 5 5 5 5 5 5 5 5 5 5 5 5 5 5 5 9 5 5 5 249 5 1 249 413 5 773 774 5 5 249 5 5 5 5 5 249 5 5 5 5 5 5 5 304 
5 5 5 5 5 5 5 5 5 5 5 5 5 5 5 5 5 5 5 5 5 5 5 5 5 5 5 5 5 5 5 5 5 5 5 5 5 5 5 5 5 5 5 5 5 5 5 5 5 5 5 5 5 5 5 5 5 5 5 5 5 5 5 5 5 5 5 5 249 5 5 1 5 5 5 9 7 7 9 1 7 775 776 777 7 9 9 7 7 5 5 5 5 5 5 5 5 5 5 304 
5 5 5 5 5 5 5 5 5 5 5 5 5 5 5 5 5 5 5 5 5 5 5 5 5 5 5 5 5 5 5 5 5 5 5 5 5 5 5 5 5 5 5 5 5 5 5 5 5 5 5 5 5 5 5 5 5 5 5 5 5 5 5 5 5 5 5 5 5 9 5 9 249 9 9 7 7 1 9 7 7 778 779 780 7 7 1 9 7 7 5 5 5 5 5 5 5 5 5 304 
5 5 5 5 5 5 5 5 5 5 5 5 5 5 5 5 5 5 5 5 5 5 5 5 5 5 5 5 5 5 5 5 5 5 5 5 5 5 5 5 5 5 5 5 5 5 5 5 5 5 5 5 5 5 5 5 5 5 5 5 5 5 5 5 5 5 5 5 1 5 5 9 9 9 7 7 9 5 7 7 9 781 782 783 5 7 7 5 1 7 7 5 5 5 5 5 5 5 5 304 
5 5 5 5 5 5 5 5 5 5 5 5 5 5 5 5 5 5 5 5 5 5 5 5 5 5 5 5 5 5 5 5 5 5 5 5 5 5 5 5 5 5 5 5 5 5 5 5 5 5 5 5 5 5 5 5 5 5 5 5 5 5 5 5 5 5 5 5 5 5 5 1 9 7 7 9 9 7 7 9 5 9 9 1 9 249 7 7 9 9 7 7 249 5 5 5 5 5 5 304 
5 5 5 5 5 5 5 5 5 5 5 5 5 5 5 5 5 5 5 5 5 5 5 5 5 5 5 5 5 5 5 5 5 5 5 5 5 5 5 5 5 9 9 1 5 5 5 5 5 5 5 5 5 5 5 5 5 5 5 5 5 5 5 5 5 5 9 5 5 249 9 9 7 7 9 5 7 7 9 5 9 1 9 9 9 9 5 7 7 9 5 7 7 9 5 5 5 5 5 304 
5 5 5 5 5 5 5 5 5 5 5 5 5 5 5 5 5 5 5 5 5 5 5 5 5 5 5 5 5 5 5 5 5 5 5 5 5 5 5 5 1 9 414 9 9 5 5 5 5 5 5 5 5 5 5 5 5 5 5 5 5 5 5 5 5 9 9 249 5 5 9 7 7 9 9 7 7 9 5 249 9 9 9 9 9 5 5 9 7 7 9 1 7 7 9 5 5 5 5 304 
5 5 5 5 5 5 5 5 5 5 5 5 5 5 5 5 5 5 5 5 5 5 5 5 5 5 5 5 5 5 5 5 5 5 5 5 5 5 5 9 9 1 413 9 9 1 5 5 5 5 5 5 5 5 5 5 5 5 5 5 5 5 5 5 249 5 1 9 9 5 7 7 9 1 7 7 249 5 1 9 249 9 9 1 5 249 9 5 9 7 7 9 9 7 7 5 5 5 5 304 
5 5 5 5 5 5 5 5 5 5 5 5 5 5 5 5 5 5 5 5 5 5 5 5 5 5 5 5 5 5 5 5 5 5 5 5 5 5 5 1 9 9 9 1 9 9 5 5 5 5 5 5 5 5 5 5 5 5 5 5 5 5 5 5 5 5 9 1 9 7 7 9 9 7 7 9 5 9 9 9 1 9 9 9 9 9 1 9 249 9 7 7 9 1 7 7 5 5 5 304 
5 5 5 5 5 5 5 5 5 5 5 5 5 5 5 5 5 5 5 5 5 5 5 5 5 5 5 5 5 5 5 5 7 7 7 7 7 7 7 7 7 7 7 7 7 7 7 7 7 7 7 7 5 5 5 5 5 5 5 5 5 5 5 5 5 5 249 5 9 9 9 1 7 7 9 9 1 5 5 9 9 9 9 1 9 5 9 9 9 9 5 7 7 1 9 9 5 5 5 304 
5 5 5 5 5 5 5 5 5 5 5 5 5 5 5 5 5 5 301 302 302 302 303 5 5 5 5 5 5 5 5 7 7 7 7 7 7 7 7 7 7 7 7 7 7 7 7 7 7 7 7 7 5 5 5 5 5 5 5 5 5 5 5 5 5 5 5 5 9 249 9 7 7 9 1 9 9 9 9 9 249 9 9 9 9 9 1 9 1 9 9 9 7 7 5 5 5 5 5 304 
5 5 5 5 5 5 5 5 5 5 5 5 5 5 5 5 5 301 312 300 300 300 311 303 5 5 5 5 9 9 5 7 7 7 7 7 7 7 7 7 7 7 7 7 7 7 7 7 7 7 7 7 7 5 5 5 5 5 5 5 5 5 5 5 5 301 302 303 5 9 1 9 5 5 9 9 9 5 9 5 9 1 9 9 1 9 9 9 5 9 9 9 5 5 249 5 5 5 5 304 
5 5 5 5 5 5 5 5 5 5 5 5 5 5 5 5 301 312 300 300 300 300 300 311 303 9 1 9 9 9 9 7 7 7 7 7 7 7 7 7 7 7 7 7 7 7 7 7 7 7 7 7 7 5 5 5 5 5 5 5 5 5 5 5 301 312 0 305 5 5 249 5 9 5 5 5 5 5 1 9 9 9 9 249 9 9 9 9 9 1 5 5 5 5 5 5 5 5 5 304 
5 5 5 5 5 5 5 5 5 5 5 5 5 5 5 301 312 300 300 300 300 300 300 300 305 9 9 9 249 1 9 9 7 7 7 7 7 7 7 7 7 7 7 7 7 7 7 7 7 7 7 7 7 5 5 5 5 5 5 5 5 5 5 301 312 0 309 308 5 5 5 5 5 5 5 5 5 9 9 9 9 9 9 9 9 1 9 9 9 5 249 5 5 5 5 5 5 5 5 304 
251 251 251 251 251 251 251 252 251 252 252 252 252 5 5 304 300 300 300 300 300 300 300 300 305 9 9 9 9 1 9 9 9 1 9 9 9 9 9 249 41 40 40 40 40 40 42 249 9 9 9 9 9 9 5 5 5 5 5 5 5 5 301 312 0 0 305 5 5 5 5 5 5 5 5 5 5 5 5 5 5 5 9 9 249 5 5 5 5 5 5 5 5 5 5 5 5 5 5 304 
251 251 251 251 251 251 251 252 251 252 252 252 252 5 5 306 310 300 300 300 300 300 300 300 311 302 303 9 9 9 9 1 9 9 9 9 9 1 9 44 1 9 9 9 9 9 1 44 9 9 1 9 9 249 9 5 5 5 5 5 301 302 312 0 0 309 308 5 5 5 9 9 9 5 249 1 9 9 5 249 414 18 16 19 5 5 5 5 5 5 5 5 5 5 5 5 5 5 5 304 
251 251 251 251 251 251 251 252 251 252 252 252 252 5 5 5 306 310 300 300 300 300 300 300 300 300 311 303 9 9 9 9 9 9 1 9 9 9 1 43 9 9 1 9 9 9 9 45 9 9 9 9 9 1 9 9 5 5 5 301 312 0 0 0 309 308 5 5 5 5 5 1 5 5 9 5 9 5 5 5 413 14 10 21 5 5 249 5 5 5 5 5 5 5 5 5 5 5 5 304 
251 251 251 251 251 251 251 252 251 252 252 252 252 5 5 5 5 304 300 300 300 300 300 300 300 300 300 311 302 303 9 9 9 9 9 1 9 9 9 45 9 9 9 9 9 9 9 249 9 1 9 9 9 9 9 9 301 302 302 312 0 0 0 0 305 5 5 5 5 5 5 5 5 5 5 5 5 5 5 5 9 14 13 5 5 5 5 5 5 5 5 5 5 5 5 5 5 5 5 304 
251 251 251 251 251 251 251 252 251 252 252 252 252 5 5 5 5 306 310 300 300 300 300 300 300 300 300 300 300 311 303 9 9 9 9 9 9 9 9 249 9 9 9 9 9 9 249 9 9 9 9 9 9 9 350 302 312 0 0 0 0 0 309 307 308 5 5 9 5 5 1 5 5 9 5 5 5 9 249 5 1 14 13 9 5 5 5 5 5 5 249 5 5 5 5 5 5 5 5 306 
251 251 251 251 251 251 251 252 251 252 252 252 252 5 5 5 5 5 306 310 300 300 300 309 307 310 300 300 300 300 311 350 302 303 9 9 9 9 249 9 9 9 9 9 1 9 44 1 9 9 249 9 301 302 350 0 0 0 0 0 0 0 305 5 5 5 5 5 5 5 9 5 5 5 5 5 1 5 5 5 5 14 13 5 5 5 5 9 5 5 5 9 5 5 5 5 5 5 5 5 
251 251 251 251 251 251 251 252 251 252 252 252 252 5 5 5 5 5 5 304 300 300 309 308 9 306 310 300 300 300 300 350 300 311 303 9 9 9 9 249 9 9 9 1 9 9 45 9 9 9 301 302 312 0 350 0 0 0 0 0 0 309 308 5 5 5 9 5 5 5 5 9 5 5 5 5 5 5 5 9 18 17 13 5 9 5 5 5 5 5 5 5 5 5 5 5 5 5 5 5 
260 260 260 260 260 260 260 252 260 252 252 252 252 5 5 5 5 5 5 306 310 300 305 1 9 9 350 350 350 350 307 350 300 300 311 302 302 302 303 9 9 9 9 9 1 9 249 9 9 301 312 0 0 0 350 0 0 0 0 0 309 308 5 5 5 5 5 5 5 5 9 5 5 5 9 5 5 9 5 9 14 6 13 5 5 5 5 5 5 5 5 9 5 9 5 9 5 5 5 5 
251 251 251 251 251 251 251 252 251 252 252 252 252 5 5 5 5 5 9 9 306 310 311 350 9 301 312 300 305 9 9 350 300 300 300 300 300 300 311 302 302 302 302 302 302 302 302 302 302 312 0 0 0 0 350 0 0 0 0 309 308 5 9 5 9 9 9 9 9 5 5 5 249 5 5 5 5 5 9 1 14 6 13 9 165 166 166 166 166 167 5 5 5 5 5 5 5 5 5 5 
251 251 251 251 251 251 251 252 251 252 252 252 252 5 5 5 5 1 9 9 9 306 310 350 302 312 300 300 305 1 301 312 300 300 300 300 300 300 300 300 300 300 300 300 300 300 300 300 300 300 300 0 0 0 350 309 307 307 307 308 5 5 5 9 9 1 1 9 9 9 9 9 9 1 9 9 9 9 1 9 14 6 13 5 168 169 169 169 169 170 5 1 5 5 5 5 5 5 5 5 
251 251 251 251 251 251 251 252 251 252 252 252 252 5 5 5 9 9 9 249 9 9 306 350 310 300 300 300 311 302 312 300 300 300 300 300 300 300 300 300 300 300 300 300 300 300 300 300 300 300 300 309 307 307 350 308 9 249 9 9 5 5 9 9 9 9 9 49 50 50 51 9 9 9 49 50 50 51 9 9 14 6 13 9 171 172 172 172 172 173 9 5 5 9 5 5 5 5 5 5 
258 258 258 258 258 258 258 264 251 252 252 252 252 5 5 9 1 9 9 9 9 249 9 9 304 300 300 300 300 300 300 300 300 300 300 300 300 300 300 300 300 300 300 300 300 300 300 300 300 300 300 305 9 1 9 9 9 9 9 9 9 9 9 1 1 9 9 52 53 54 55 9 9 9 52 53 54 55 9 9 14 6 13 9 174 175 176 177 178 179 9 9 5 186 187 187 187 188 9 9 
251 251 251 251 251 251 251 251 251 252 252 252 252 5 5 5 9 9 414 9 9 1 9 9 306 310 300 300 300 300 300 300 300 300 300 300 300 300 300 300 300 300 300 300 300 300 300 300 300 300 300 305 9 9 9 1 9 9 1 9 249 9 9 9 9 9 9 56 57 58 59 9 1 9 56 57 58 59 9 9 14 6 13 9 180 181 182 183 184 185 249 1 189 190 191 191 191 192 193 9 
258 258 258 258 258 258 258 258 259 256 252 252 252 5 5 9 249 9 413 9 9 9 9 9 9 306 307 310 300 300 300 300 300 300 300 300 300 300 300 300 300 300 300 300 300 300 300 300 300 300 0 311 303 5 9 9 9 9 9 9 9 1 9 18 16 16 16 17 6 15 16 16 16 16 17 6 15 16 16 16 17 6 15 16 16 16 17 6 15 16 16 16 194 195 196 196 196 197 198 16 
9 9 9 9 249 9 9 249 9 1 252 252 252 5 5 9 9 1 9 9 9 1 9 9 249 9 5 306 307 307 310 300 300 300 300 300 300 300 300 300 300 300 300 300 300 309 307 307 307 310 0 0 311 303 5 5 9 5 9 1 9 9 9 14 6 6 6 6 6 6 6 6 6 6 6 6 6 6 6 6 6 6 6 6 6 6 6 6 6 6 6 6 199 200 201 201 201 202 203 6 
9 9 9 9 9 9 249 249 9 9 252 252 252 5 5 5 9 9 9 1 9 7 7 7 7 7 5 5 5 5 306 307 307 307 307 307 307 307 307 307 307 307 307 307 307 308 5 5 5 306 310 0 0 305 9 9 9 9 9 9 9 9 9 20 11 11 11 11 11 11 11 11 11 11 11 11 11 11 11 11 12 6 10 11 11 11 11 11 11 11 11 11 204 131 206 206 206 135 208 11 
249 9 249 9 9 249 9 249 1 9 252 252 252 5 5 9 1 9 9 9 9 7 7 7 7 7 7 5 5 5 9 9 9 7 7 7 7 7 7 7 7 7 7 7 7 9 9 9 9 9 304 0 0 305 9 9 9 1 9 249 9 9 1 9 9 249 9 49 50 50 51 9 9 1 62 63 64 65 66 9 14 6 13 9 249 9 9 9 9 9 1 9 5 5 5 5 5 5 9 9 
258 258 258 258 258 258 258 258 254 255 264 252 252 5 5 9 9 9 9 9 7 7 7 7 7 7 7 7 5 5 1 9 1 7 7 7 7 7 7 7 7 7 7 7 7 1 9 9 9 1 304 0 0 311 303 8 9 9 9 9 9 9 9 9 9 1 9 52 53 54 55 9 9 9 67 68 69 70 71 9 14 6 13 9 9 9 9 1 9 9 9 9 5 5 5 5 5 5 5 5 
258 258 258 258 258 258 258 258 254 255 258 264 252 9 9 1 9 9 1 9 7 7 7 7 7 7 7 7 7 5 9 9 9 7 7 7 7 7 7 7 7 7 7 7 7 9 9 9 9 9 306 310 0 8 8 8 8 9 9 9 9 5 5 9 9 9 9 56 57 58 59 9 9 9 72 73 74 75 76 1 14 6 13 9 140 139 139 139 139 139 141 9 5 5 5 5 5 5 5 5 
258 258 258 258 258 258 258 258 254 255 258 258 256 5 9 9 1 9 9 9 7 7 7 7 7 7 7 7 7 5 9 9 9 7 7 7 7 7 7 7 7 7 7 7 7 9 9 1 9 1 9 306 8 8 8 8 8 9 9 5 5 9 5 5 9 9 9 14 6 15 19 9 9 1 77 78 79 80 81 9 14 6 13 1 143 7 7 7 7 7 144 5 5 5 5 5 5 5 5 5 
5 5 5 5 5 5 5 5 9 1 9 9 9 5 5 9 9 9 9 7 7 7 7 7 7 7 7 7 7 5 9 1 9 7 7 7 7 7 7 7 7 7 7 7 7 9 1 9 9 9 9 8 8 8 8 8 305 5 9 5 5 5 5 5 5 9 9 14 6 6 15 16 16 16 16 17 6 15 16 16 17 6 13 9 143 22 7 7 22 7 144 5 5 5 5 5 5 5 5 5 
5 5 5 5 5 5 5 5 9 9 9 9 1 9 9 9 9 9 9 7 7 7 7 7 7 7 7 7 7 9 9 9 9 7 7 7 7 7 7 7 7 7 7 7 7 9 9 9 9 9 8 8 8 8 8 0 311 303 5 9 5 9 5 5 5 5 5 20 12 6 6 6 6 6 6 6 6 6 6 6 6 6 13 9 143 7 7 7 7 22 144 5 5 5 5 5 5 5 5 5 
5 5 5 5 5 5 5 5 9 1 9 9 9 1 9 5 5 249 9 7 7 7 7 7 7 7 7 7 7 5 9 1 9 7 7 7 7 7 7 7 7 7 7 7 7 9 9 1 9 9 9 8 8 306 310 0 0 311 303 5 5 5 5 5 5 9 5 5 20 11 11 11 11 11 11 11 11 11 11 11 12 6 13 9 143 7 22 7 22 7 144 5 5 5 5 5 5 5 5 5 
5 5 5 5 5 5 5 5 9 9 1 9 9 9 9 9 5 5 7 7 7 7 7 7 7 7 7 7 7 5 9 9 1 7 7 7 7 7 7 7 7 7 7 7 7 9 9 9 9 9 9 9 9 9 306 310 0 0 311 303 9 5 5 5 5 5 5 5 5 5 5 9 9 9 9 9 9 9 1 249 14 6 13 9 143 7 7 7 7 7 144 5 5 5 5 5 5 5 5 5 
5 5 5 5 5 5 5 5 5 5 5 5 5 5 5 5 5 5 5 5 5 5 5 5 5 5 5 5 5 5 5 5 5 5 5 5 5 5 5 5 5 5 5 5 5 5 9 9 9 1 9 9 9 9 5 304 0 0 0 311 303 5 5 5 5 9 5 5 5 5 5 5 5 5 5 5 9 9 9 9 14 6 13 9 142 139 139 139 139 139 145 5 5 5 5 5 5 5 5 5 
5 5 5 5 5 5 5 5 5 5 5 5 5 5 5 5 5 5 5 5 5 5 5 5 5 5 5 5 5 5 5 5 5 5 5 5 5 5 5 5 5 5 5 5 5 5 5 5 5 5 5 5 5 5 5 306 307 310 0 0 311 303 9 5 5 9 5 9 5 5 5 5 5 5 5 5 5 9 9 1 14 6 13 9 9 9 9 9 9 5 5 5 5 5 5 5 5 5 5 5 
5 5 5 5 5 5 5 5 5 5 5 5 5 5 5 5 5 5 5 5 5 5 5 5 5 5 5 5 5 5 5 5 5 5 5 5 5 5 5 5 5 5 5 5 5 5 5 5 5 5 5 5 5 5 5 5 5 306 310 0 0 305 5 5 5 5 5 5 5 5 5 5 5 5 5 5 5 5 5 9 14 6 13 9 9 1 9 5 5 5 5 5 5 5 5 25 26 26 26 26 
5 5 5 5 5 5 5 5 5 5 5 5 5 5 5 5 5 5 5 5 5 5 5 5 5 5 5 5 5 5 5 5 5 5 5 5 5 5 5 5 5 5 5 5 5 5 5 5 5 5 5 5 5 5 5 5 5 5 304 0 0 311 303 5 5 5 5 5 5 5 5 5 5 5 5 5 5 5 5 5 14 6 13 9 5 5 5 5 5 1 9 9 5 25 26 36 24 24 3 24 
5 5 5 5 5 5 5 5 5 5 5 5 5 5 5 5 5 5 5 5 5 5 5 5 5 5 5 5 5 5 5 5 5 5 5 5 5 5 5 5 5 5 5 5 5 5 5 5 5 5 5 5 5 5 5 5 5 5 306 310 0 0 305 5 5 5 5 5 5 5 5 5 5 5 5 5 5 5 5 5 14 6 13 5 5 5 5 1 9 9 25 368 26 36 24 24 3 24 24 24 
5 5 5 5 5 5 5 5 5 5 5 5 5 5 5 5 5 5 5 5 5 5 5 5 5 5 5 5 5 5 5 5 5 5 5 5 5 5 5 5 5 5 5 5 5 5 5 5 5 5 5 5 5 5 5 5 5 5 5 304 0 0 311 303 5 5 5 5 5 5 5 5 5 5 5 5 5 5 5 5 14 6 13 5 5 5 9 7 25 26 36 367 3 33 31 31 31 31 31 31 
5 5 5 5 5 5 5 5 5 5 5 5 5 5 5 5 5 5 5 5 5 5 5 5 5 5 5 5 5 5 5 5 5 5 5 5 5 5 5 5 5 5 5 5 5 5 5 5 5 5 5 5 5 5 5 5 5 5 5 306 310 0 0 311 303 5 5 5 5 5 5 5 5 5 5 5 9 9 1 7 14 6 13 9 7 7 7 25 36 3 367 33 31 32 5 5 5 5 5 5 
5 5 5 5 5 5 5 5 5 5 5 5 5 5 5 5 5 5 5 5 5 5 5 5 5 5 5 5 5 5 5 5 5 5 5 5 5 5 5 5 5 5 5 5 5 5 5 5 5 5 5 5 5 5 5 5 5 5 5 5 306 310 0 0 305 5 5 5 5 5 5 5 5 5 1 9 7 7 7 7 20 11 21 7 7 25 26 36 33 371 31 32 5 5 5 5 5 5 5 5 
5 5 5 5 5 5 5 5 5 5 5 5 5 5 5 5 5 5 5 5 5 5 5 5 5 5 5 5 5 5 5 5 5 5 5 5 5 5 5 5 5 5 5 5 5 5 5 5 5 5 5 5 5 5 5 5 5 5 5 5 5 304 0 0 305 5 5 5 5 5 5 5 5 5 9 7 7 7 7 7 25 26 26 26 26 36 33 31 32 7 5 5 5 5 5 5 5 5 5 5 
5 5 5 5 5 5 5 5 5 5 5 5 5 5 5 5 5 5 5 5 5 5 5 5 5 5 5 5 5 5 5 5 5 5 5 5 5 5 5 5 5 5 5 5 5 5 5 5 5 5 5 5 5 5 5 5 5 5 5 5 5 306 310 0 311 303 5 5 5 5 5 5 5 1 7 7 7 25 26 26 36 24 24 3 33 31 32 7 7 7 5 5 5 5 5 5 5 5 5 5 
5 5 5 5 5 5 5 5 5 5 5 5 5 5 5 5 5 5 5 5 5 5 5 5 5 5 5 5 5 5 5 5 5 5 5 5 5 5 5 5 5 5 5 5 5 5 5 5 5 5 5 5 5 5 5 5 5 5 5 5 5 5 306 307 307 308 5 5 5 5 5 5 5 25 26 26 26 36 3 33 31 31 31 31 32 7 7 7 7 7 5 5 5 5 5 5 5 5 5 5 
5 5 5 5 5 5 5 5 5 5 5 5 5 5 5 5 5 5 5 5 5 5 5 5 5 5 5 5 5 5 5 5 5 5 5 5 5 5 5 5 5 5 5 5 5 5 5 5 5 5 5 5 5 5 5 5 5 5 5 5 5 5 5 5 5 5 5 5 5 5 5 25 26 36 24 24 33 31 31 32 7 7 7 7 7 7 7 7 7 7 5 5 5 5 5 5 5 5 5 5 
5 5 5 5 5 5 5 5 5 5 5 5 5 5 5 5 5 5 5 5 5 5 5 5 5 5 5 5 5 5 5 5 5 5 5 5 5 5 5 5 5 5 5 5 5 5 5 5 5 5 5 5 5 5 5 5 5 5 5 5 5 5 5 5 5 5 5 5 5 1 25 36 24 24 33 31 32 9 9 7 7 7 7 7 7 7 7 7 7 1 5 5 5 5 5 5 5 5 5 5 
5 5 5 5 5 5 5 5 5 5 5 5 5 5 5 5 5 5 5 5 5 5 5 5 5 5 5 5 5 5 5 5 5 5 5 5 5 5 5 5 5 5 5 5 5 5 5 5 5 5 5 5 5 5 5 5 5 5 5 5 5 5 5 5 5 5 5 5 9 25 36 24 3 33 32 9 9 1 7 7 7 7 7 7 7 7 7 7 7 7 5 5 5 5 5 5 5 5 5 5 
5 5 5 5 5 5 5 5 5 5 5 5 5 5 5 5 5 5 5 5 5 5 5 5 5 5 5 5 5 5 5 5 5 5 5 5 5 5 5 5 5 5 5 5 5 5 5 5 5 5 5 5 5 5 5 5 5 5 5 5 5 5 5 5 5 5 5 9 25 36 24 24 33 32 9 9 9 9 7 7 7 7 7 7 7 7 7 7 7 7 5 5 5 5 5 5 5 5 5 5 
5 5 5 5 5 5 5 5 5 5 5 5 5 5 5 5 5 5 5 5 5 5 5 5 5 5 5 5 5 5 5 5 5 5 5 5 5 5 5 5 5 5 5 5 5 5 5 5 5 5 5 5 5 5 5 5 5 5 5 5 5 5 5 5 5 5 5 1 28 3 24 24 29 9 9 9 1 1 9 7 7 7 7 7 7 7 7 7 7 7 5 5 5 5 5 5 5 5 5 5 
5 5 5 5 5 5 5 5 5 5 5 5 5 5 5 5 5 5 5 5 5 5 5 5 5 5 5 5 5 5 5 5 5 5 5 5 5 5 5 5 5 5 5 5 5 5 5 5 5 5 5 5 5 5 5 5 5 5 5 5 5 5 5 5 5 5 5 9 28 24 24 24 29 9 1 9 249 9 9 9 9 9 1 9 9 9 9 9 7 7 5 5 5 5 5 5 5 5 5 5 
5 5 5 5 5 5 5 5 5 5 5 5 5 5 5 5 5 5 5 5 5 5 5 5 5 5 5 5 5 5 5 5 5 5 5 5 5 5 5 5 5 5 5 5 5 5 5 5 5 5 5 5 5 5 5 5 5 5 5 5 5 5 5 5 5 5 5 5 28 24 24 24 35 27 9 9 9 9 9 1 9 9 25 26 26 26 27 9 1 9 5 5 5 5 5 5 5 5 5 5 
5 5 5 5 5 5 5 5 5 5 5 5 5 5 5 5 5 5 5 5 5 5 5 5 5 5 5 5 5 5 5 5 5 5 5 5 5 5 5 5 5 5 5 5 5 5 5 5 5 5 5 5 5 5 5 5 5 5 5 5 5 5 5 5 5 5 5 5 30 31 34 24 3 35 26 26 26 26 26 26 26 26 36 24 24 24 35 27 9 249 5 5 5 5 5 5 5 5 5 5 
5 5 5 5 5 5 5 5 5 5 5 5 5 5 5 5 5 5 5 5 5 5 5 5 5 5 5 5 5 5 5 5 5 5 5 5 5 5 5 5 5 5 5 5 5 5 5 5 5 5 5 5 5 5 5 5 5 5 5 5 5 5 5 5 5 5 5 5 5 5 30 34 24 24 24 24 24 24 24 24 3 24 24 24 24 24 24 35 27 1 5 5 5 5 5 5 5 5 5 5 
5 5 5 5 5 5 5 5 5 5 5 5 5 5 5 5 5 5 5 5 5 5 5 5 5 5 5 5 5 5 5 5 5 5 5 5 5 5 5 5 5 5 5 5 5 5 5 5 5 5 5 5 5 5 5 5 5 5 5 5 5 5 5 5 5 5 5 5 5 5 5 28 24 24 3 24 33 31 34 24 24 24 24 24 3 24 24 24 29 9 5 5 5 5 5 5 5 5 5 5 
5 5 5 5 5 5 5 5 5 5 5 5 5 5 5 5 5 5 5 5 5 5 5 5 5 5 5 5 5 5 5 5 5 5 5 5 5 5 5 5 5 5 5 5 5 5 5 5 5 5 5 5 5 5 5 5 5 5 5 5 5 5 5 5 5 5 5 5 5 5 5 30 31 31 34 33 32 9 30 31 34 24 24 24 24 24 24 24 35 27 5 5 5 5 5 5 5 5 5 5 
5 5 5 5 5 5 5 5 5 5 5 5 5 5 5 5 5 5 5 5 5 5 5 5 5 5 5 5 5 5 5 5 5 5 5 5 5 5 5 5 5 5 5 5 5 5 5 5 5 5 5 5 5 5 5 5 5 5 5 5 5 5 5 5 5 5 5 5 5 5 5 5 5 5 30 32 9 5 9 9 30 31 34 24 24 3 24 24 24 35 27 5 5 5 5 5 5 5 5 5 
5 5 5 5 5 5 5 5 5 5 5 5 5 5 5 5 5 5 5 5 5 5 5 5 5 5 5 5 5 5 5 5 5 5 5 5 5 5 5 5 5 5 5 5 5 5 5 5 5 5 5 5 5 5 5 5 5 5 5 5 5 5 5 5 5 5 5 5 5 5 5 5 5 5 5 5 9 9 9 1 9 9 30 31 34 24 24 24 3 24 35 368 27 5 5 5 5 5 5 5 
5 5 5 5 5 5 5 5 5 5 5 5 5 5 5 5 5 5 5 5 5 5 5 5 5 5 5 5 5 5 5 5 5 5 5 5 5 5 5 5 5 5 5 5 5 5 5 5 5 5 5 5 5 5 5 5 5 5 5 5 5 5 5 5 5 5 5 5 5 5 5 5 5 5 5 5 9 9 9 5 9 9 9 249 30 34 24 24 24 24 24 367 35 27 5 5 5 5 5 5 
5 5 5 5 5 5 5 5 5 5 5 5 5 5 5 5 5 5 5 5 5 5 5 5 5 5 5 5 5 5 5 5 5 5 5 5 5 5 5 5 5 5 5 5 5 5 5 5 5 5 5 5 5 5 5 5 5 5 5 5 5 5 5 5 5 5 5 5 5 5 5 5 5 5 5 9 249 1 9 9 18 16 19 1 9 30 31 34 24 3 24 367 3 35 27 5 5 5 5 5 
5 5 5 5 5 5 5 5 5 5 5 5 5 5 5 5 5 5 5 5 5 5 5 5 5 5 5 5 5 5 5 5 5 5 5 5 5 5 5 5 5 5 5 5 5 5 5 5 5 5 5 5 5 5 5 5 5 5 5 5 5 5 5 5 5 5 5 5 5 5 5 5 5 5 5 9 9 5 9 1 14 6 13 9 9 9 9 30 31 31 31 34 367 24 35 26 27 5 5 5 
5 5 5 5 5 5 5 5 5 5 5 5 5 5 5 5 5 5 5 5 5 5 5 5 5 5 5 5 5 5 5 5 5 5 5 5 5 5 5 5 5 5 5 5 5 5 5 5 5 5 5 5 5 5 5 5 5 5 5 5 5 5 5 5 5 5 5 5 5 5 5 5 5 5 5 1 9 9 9 9 14 6 13 9 1 249 9 5 5 5 5 30 371 34 3 24 35 27 5 5 
5 5 5 5 5 5 5 5 5 5 5 5 5 5 5 5 5 5 5 5 5 5 5 5 5 5 5 5 5 5 5 5 5 5 5 5 5 5 5 5 5 5 5 5 5 5 5 5 5 5 5 5 5 5 5 5 5 5 5 5 5 5 5 5 5 5 5 5 5 5 5 5 5 5 5 9 5 9 9 5 14 6 13 5 9 1 9 5 5 5 5 5 5 30 34 24 24 35 27 5 
5 5 5 5 5 5 5 5 5 5 5 5 5 5 5 5 5 5 5 5 5 5 5 5 5 5 5 5 5 5 5 5 5 5 5 5 5 5 5 5 5 5 5 5 5 5 5 5 5 5 5 5 5 5 5 5 5 5 5 5 5 5 5 5 5 5 5 5 5 5 5 5 5 5 5 9 9 1 9 9 14 6 13 9 5 249 9 5 5 5 5 5 5 5 30 34 24 24 35 26 
5 5 5 5 5 5 5 5 5 5 5 5 5 5 5 5 5 5 5 5 5 5 5 5 5 5 5 5 5 5 5 5 5 5 5 5 5 5 5 5 5 5 5 5 5 5 5 5 5 5 5 5 5 5 5 5 5 5 5 5 5 5 5 5 5 5 5 5 5 5 5 5 5 5 5 9 9 9 9 1 14 6 13 9 9 1 5 5 5 5 5 5 5 5 5 30 34 24 24 24 
5 5 5 5 5 5 5 5 5 5 5 5 5 5 5 5 5 5 5 5 5 5 5 5 5 5 5 5 5 5 5 5 5 5 5 5 5 5 5 5 5 5 5 5 5 5 5 5 5 5 5 5 5 5 5 5 5 5 5 5 5 5 5 5 5 5 5 5 5 5 5 5 5 5 5 5 5 1 9 9 14 6 13 9 1 9 5 5 5 5 5 5 5 5 5 5 30 34 24 24 
5 5 5 5 5 5 5 5 5 5 5 5 5 5 5 5 5 5 5 5 5 5 5 5 5 5 5 5 5 5 5 5 5 5 5 5 5 5 5 5 5 5 5 5 5 5 5 5 5 5 5 5 5 5 5 5 5 5 5 5 5 5 5 5 5 5 5 5 5 5 5 5 5 5 5 5 9 249 5 9 114 115 116 9 9 249 5 5 5 5 5 5 5 5 5 5 5 30 31 31 
5 5 5 5 5 5 5 5 5 5 5 5 5 5 5 5 5 5 5 5 5 5 5 5 5 5 5 5 5 5 5 5 5 5 5 5 5 5 5 5 5 5 5 5 5 5 5 5 5 5 5 5 5 5 5 5 5 5 5 5 5 5 5 5 5 5 5 5 5 5 5 5 5 5 5 5 5 5 5 186 117 118 119 188 9 5 5 5 5 5 5 5 5 5 5 5 5 5 5 5 
5 5 5 5 5 5 5 5 5 5 5 5 5 5 5 5 5 5 5 5 5 5 5 5 5 5 5 5 5 5 5 5 5 5 5 5 5 5 5 5 5 5 5 5 5 5 5 5 5 5 5 5 5 5 5 5 5 5 5 5 5 5 5 5 5 5 5 5 5 5 5 5 5 5 5 5 5 5 5 190 191 191 191 192 5 5 5 5 5 5 5 5 5 5 5 5 5 5 5 5 
5 5 5 5 5 5 5 5 5 5 5 5 5 5 5 5 5 5 5 5 5 5 5 5 5 5 5 5 5 5 5 5 5 5 5 5 5 5 5 5 5 5 5 5 5 5 5 5 5 5 5 5 5 5 5 5 5 5 5 5 5 5 5 5 5 5 5 5 5 5 5 5 5 5 5 5 5 5 5 195 196 196 196 197 5 5 5 5 5 5 5 5 5 5 5 5 5 5 5 5 
5 5 5 5 5 5 5 5 5 5 5 5 5 5 5 5 5 5 5 5 5 5 5 5 5 5 5 5 5 5 5 5 5 5 5 5 5 5 5 5 5 5 5 5 5 5 5 5 5 5 5 5 5 5 5 5 5 5 5 5 5 5 5 5 5 5 5 5 5 5 5 5 5 5 5 5 5 5 5 126 127 128 129 130 5 5 5 5 5 5 5 5 5 5 5 5 5 5 5 5 
5 5 5 5 5 5 5 5 5 5 5 5 5 5 5 5 5 5 5 5 5 5 5 5 5 5 5 5 5 5 5 5 5 5 5 5 5 5 5 5 5 5 5 5 5 5 5 5 5 5 5 5 5 5 5 5 5 5 5 5 5 5 5 5 5 5 5 5 5 5 5 5 5 5 5 5 5 5 5 131 132 133 134 135 5 5 5 5 5 5 5 5 5 5 5 5 5 5 5 5 
5 5 5 5 5 5 5 5 5 5 5 5 5 5 5 5 5 5 5 5 5 5 5 5 5 5 5 5 5 5 5 5 5 5 5 5 5 5 5 5 5 5 5 5 5 5 5 5 5 5 5 5 5 5 5 5 5 5 5 5 5 5 5 5 5 5 5 5 5 5 5 5 5 5 5 5 5 5 5 5 136 137 138 5 5 5 5 5 5 5 5 5 5 5 5 5 5 5 5 5 
5 5 5 5 5 5 5 5 5 5 5 5 5 5 5 5 5 5 5 5 5 5 5 5 5 5 5 5 5 5 5 5 5 5 5 5 5 5 5 5 5 5 5 5 5 5 5 5 5 5 5 5 5 5 5 5 5 5 5 5 5 5 5 5 5 5 5 5 5 5 5 5 5 5 5 5 5 5 5 5 5 5 5 5 5 5 5 5 5 5 5 5 5 5 5 5 5 5 5 5 
5 5 5 5 5 5 5 5 5 5 5 5 5 5 5 5 5 5 5 5 5 5 5 5 5 5 5 5 5 5 5 5 5 5 5 5 5 5 5 5 5 5 5 5 5 5 5 5 5 5 5 5 5 5 5 5 5 5 5 5 5 5 5 5 5 5 5 5 5 5 5 5 5 5 5 5 5 5 5 5 5 5 5 5 5 5 5 5 5 5 5 5 5 5 5 5 5 5 5 5 
5 5 5 5 5 5 5 5 5 5 5 5 5 5 5 5 5 5 5 5 5 5 5 5 5 5 5 5 5 5 5 5 5 5 5 5 5 5 5 5 5 5 5 5 5 5 5 5 5 5 5 5 5 5 5 5 5 5 5 5 5 5 5 5 5 5 5 5 5 5 5 5 5 5 5 5 5 5 5 5 5 5 5 5 5 5 5 5 5 5 5 5 5 5 5 5 5 5 5 5 
5 5 5 5 5 5 5 5 5 5 5 5 5 5 5 5 5 5 5 5 5 5 5 5 5 5 5 5 5 5 5 5 5 5 5 5 5 5 5 5 5 5 5 5 5 5 5 5 5 5 5 5 5 5 5 5 5 5 5 5 5 5 5 5 5 5 5 5 5 5 5 5 5 5 5 5 5 5 5 5 5 5 5 5 5 5 5 5 5 5 5 5 5 5 5 5 5 5 5 5 
5 5 5 5 5 5 5 5 5 5 5 5 5 5 5 5 5 5 5 5 5 5 5 5 5 5 5 5 5 5 5 5 5 5 5 5 5 5 5 5 5 5 5 5 5 5 5 5 5 5 5 5 5 5 5 5 5 5 5 5 5 5 5 5 5 5 5 5 5 5 5 5 5 5 5 5 5 5 5 5 5 5 5 5 5 5 5 5 5 5 5 5 5 5 5 5 5 5 5 5 
