5 5 5 5 5 5 5 5 5 5 5 5 5 5 5 5 5 5 5 5 5 5 5 5 5 5 5 5 5 5 5 5 5 5 5 5 5 5 5 5 5 5 5 5 5 5 5 5 5 5 5 5 5 5 5 5 5 5 5 5 5 5 5 5 5 5 5 5 5 5 5 5 5 5 5 5 5 5 5 5 5 5 5 5 5 5 5 5 5 5 5 5 5 5 5 5 5 5 5 5 
5 5 5 5 5 5 5 5 5 5 5 5 5 5 5 5 5 5 5 5 5 5 5 5 5 5 5 5 5 5 5 5 5 5 5 5 5 5 5 5 5 5 5 5 5 5 5 5 5 5 5 5 5 5 5 5 5 5 5 5 5 5 5 5 5 5 5 5 5 5 5 5 5 5 5 5 5 5 5 5 5 5 5 5 5 5 5 5 5 5 5 5 5 5 5 5 5 5 5 5 
5 5 5 5 5 5 5 5 5 5 5 5 5 5 5 5 5 5 5 5 5 5 5 5 5 5 5 5 5 5 5 5 5 5 5 5 5 5 5 5 5 5 5 5 5 5 5 5 5 5 5 5 5 5 5 5 5 5 5 5 5 5 5 5 5 5 5 5 5 5 5 5 5 5 5 5 5 5 5 5 5 5 5 5 5 5 5 5 5 5 5 5 5 5 5 5 5 5 5 5 
5 5 5 5 5 5 5 5 5 5 5 5 5 5 5 5 5 5 5 5 5 5 5 5 5 5 5 5 5 5 5 5 5 5 5 5 5 5 5 5 5 5 5 5 5 5 5 5 5 5 5 5 5 5 5 5 5 5 5 5 5 5 5 5 5 5 5 5 5 5 5 5 5 5 5 5 5 5 5 5 5 5 5 5 5 5 5 5 5 5 5 5 5 5 5 5 5 5 5 5 
5 5 5 5 5 5 5 5 5 5 5 5 5 5 5 5 5 5 5 5 5 5 5 5 5 5 5 5 5 5 5 5 5 5 5 5 5 5 5 5 5 5 5 5 5 5 5 5 5 5 5 5 5 5 5 5 5 5 5 5 5 5 5 5 5 5 5 5 5 5 5 5 5 5 5 5 5 5 5 5 5 5 5 5 5 5 5 5 5 5 5 5 5 5 5 5 5 5 5 5 
5 5 5 5 5 5 5 5 5 5 5 5 5 5 5 5 5 5 5 5 5 5 5 5 5 5 5 5 9 18 16 19 9 5 5 5 18 16 16 16 16 19 5 5 5 5 5 5 5 5 25 368 26 26 26 26 26 26 26 26 26 26 27 5 5 5 5 5 5 5 5 5 5 5 5 5 5 5 5 5 5 5 5 5 5 5 5 5 5 5 5 5 5 5 5 5 5 5 5 5 
5 5 5 5 5 5 5 5 5 5 5 5 5 5 5 5 5 5 5 9 1 9 9 9 9 9 5 9 18 17 6 15 19 9 5 9 14 6 6 6 6 13 5 9 414 9 5 5 5 25 36 367 24 24 24 24 3 24 24 24 24 367 35 27 5 5 5 5 5 5 5 5 5 5 5 5 5 5 5 5 5 5 5 5 5 5 5 5 5 5 5 5 5 5 5 5 5 5 5 5 
5 5 5 5 5 5 5 5 5 5 5 5 5 5 5 5 5 5 1 9 9 9 9 1 9 9 9 9 14 6 6 6 13 9 9 9 20 11 11 11 11 21 9 9 413 9 9 1 25 36 24 24 367 3 24 24 24 3 24 24 24 24 24 29 5 5 5 5 5 5 5 5 5 5 5 5 5 5 5 5 5 5 5 5 5 5 5 5 5 5 5 5 5 5 5 5 5 5 5 5 
5 5 5 5 5 5 5 5 5 9 9 9 9 186 187 187 187 188 9 9 9 9 9 9 5 5 9 1 20 12 6 10 21 9 9 9 9 5 5 9 9 1 9 9 9 9 25 26 36 24 24 367 367 24 24 24 367 367 24 3 24 24 3 35 27 5 5 5 5 5 5 5 5 5 5 5 5 5 5 5 5 5 5 5 5 5 5 5 5 5 5 5 5 5 5 5 5 5 5 5 
5 5 5 5 5 5 5 5 5 9 9 9 189 190 191 191 191 192 193 9 1 9 9 5 5 5 9 9 9 20 11 21 9 9 9 9 9 9 5 9 9 9 9 9 1 25 36 3 24 24 367 3 24 367 24 367 24 24 367 24 24 24 367 24 29 5 5 5 5 5 5 5 5 5 5 5 5 5 5 5 5 5 5 5 5 5 5 5 5 5 5 5 5 5 5 5 5 5 5 5 
5 5 5 5 5 5 5 5 5 9 18 16 194 195 196 196 196 197 198 19 9 9 5 5 5 5 9 9 1 5 5 5 5 9 1 9 9 9 9 9 1 9 25 26 26 36 24 24 24 24 24 24 24 24 367 24 24 367 24 24 24 24 3 24 35 27 5 5 5 5 5 5 5 5 5 5 5 5 5 5 5 5 5 5 5 5 5 5 5 5 5 5 5 5 5 5 5 5 5 5 
5 5 5 5 5 5 5 5 5 9 14 6 199 200 201 201 201 202 203 13 9 9 9 9 5 9 9 9 9 5 5 5 5 9 9 5 5 5 9 9 25 26 36 24 24 3 24 24 367 24 24 3 24 24 24 3 24 24 367 24 3 24 24 24 24 29 5 5 5 5 5 5 5 5 5 5 5 5 5 5 5 5 5 5 5 5 5 5 5 5 5 5 5 5 5 5 5 5 5 5 
5 5 5 5 5 5 5 5 5 9 20 11 204 131 206 206 206 135 208 21 9 9 9 9 9 1 9 9 9 5 5 5 9 9 5 5 5 5 5 25 36 24 24 24 367 24 3 24 24 24 24 24 24 24 24 24 24 24 24 367 24 24 24 24 367 29 5 5 5 5 5 5 5 5 5 5 5 5 5 5 5 5 5 5 5 5 5 5 5 5 5 5 5 5 5 5 5 5 5 5 
5 5 5 5 5 5 5 5 5 9 9 9 9 5 5 5 5 5 9 9 9 1 9 9 18 16 16 19 9 9 9 9 9 9 5 5 5 25 26 36 3 24 24 24 24 24 24 24 24 24 24 3 24 24 24 24 367 24 24 24 367 367 367 24 33 32 5 5 5 5 5 5 5 5 5 5 5 5 5 5 5 5 5 5 5 5 5 5 5 5 5 5 5 5 5 5 5 5 5 5 
5 5 5 5 5 5 5 5 5 5 5 5 5 5 5 5 5 5 9 9 9 1 9 9 14 6 6 13 9 9 1 9 9 9 9 5 25 36 24 24 367 24 3 24 24 24 24 24 3 24 24 24 24 24 24 24 24 3 24 24 24 24 3 367 370 5 5 5 5 5 414 5 5 5 5 5 5 5 5 5 5 5 5 5 5 5 5 5 5 5 5 5 5 5 5 5 5 5 5 5 
5 5 5 5 5 5 5 5 5 5 5 5 5 5 5 5 5 5 1 9 9 9 9 9 14 6 10 21 9 9 9 9 9 9 9 25 36 24 24 24 24 24 24 24 367 24 24 24 24 24 367 24 3 367 24 24 24 24 24 24 24 24 3 33 32 5 5 5 9 1 413 5 5 5 5 5 5 5 5 5 5 5 5 5 5 5 5 5 5 5 5 5 5 5 5 5 5 5 5 5 
5 5 5 5 5 5 5 5 5 5 5 5 5 5 5 5 5 5 5 5 5 9 9 1 20 11 21 9 9 5 5 9 9 9 1 28 24 3 24 24 24 24 24 24 24 24 3 24 24 24 3 24 24 24 24 3 24 24 24 24 24 24 33 32 5 5 5 5 1 9 9 5 5 5 5 5 5 5 5 5 5 5 5 5 5 5 5 5 5 5 5 5 5 5 5 5 5 5 5 5 
5 5 5 5 5 5 5 5 5 5 5 5 5 5 5 5 5 5 5 5 5 5 5 5 9 9 9 9 9 5 9 9 9 9 9 28 24 24 24 24 24 24 3 24 24 24 24 24 24 3 24 24 3 24 24 24 24 24 3 24 3 33 32 7 7 7 5 5 7 7 7 7 5 5 5 5 5 5 5 5 5 5 5 5 5 5 5 5 5 5 5 5 5 5 5 5 5 5 5 5 
5 5 5 5 5 5 5 5 5 5 5 5 5 5 5 5 5 5 5 5 5 5 5 5 5 5 5 5 9 9 9 9 1 9 9 28 24 24 367 3 24 24 24 24 24 24 367 24 24 24 24 24 24 24 24 24 24 24 24 24 33 32 7 7 7 249 7 7 7 249 7 7 9 249 5 5 5 5 5 5 5 5 5 5 5 5 5 5 5 5 5 5 5 5 5 5 5 5 5 5 
5 5 5 5 5 5 5 5 5 5 5 5 5 5 5 5 5 5 5 5 5 5 5 5 5 5 5 5 5 5 9 9 9 9 9 30 34 24 24 24 24 367 24 3 24 24 24 24 24 24 3 24 24 24 24 367 3 24 24 33 32 7 7 7 7 7 7 7 7 7 7 7 5 1 9 5 5 5 5 5 5 5 5 5 5 5 5 5 5 5 5 5 5 5 5 5 5 5 5 5 
5 5 5 5 5 5 5 5 5 5 5 5 5 5 5 5 5 5 5 5 5 5 5 5 5 5 5 5 5 5 5 5 9 9 9 1 30 34 24 24 24 24 24 24 24 24 24 367 3 24 24 24 24 24 24 24 24 3 33 32 7 7 7 7 7 7 7 7 7 7 7 7 7 9 249 5 5 5 5 5 5 5 5 5 5 5 5 5 5 5 5 5 5 5 5 5 5 5 5 5 
5 5 5 5 5 5 5 5 5 5 5 5 5 5 5 5 5 5 5 5 5 5 5 5 5 5 5 5 5 5 5 5 5 5 5 5 5 30 34 24 3 24 24 24 24 24 24 24 24 24 24 24 24 24 24 3 24 33 32 7 7 7 7 7 7 7 7 249 7 7 7 7 7 7 9 9 5 5 5 5 5 5 5 5 5 5 5 5 5 5 5 5 5 5 5 5 5 5 5 5 
5 5 5 5 5 5 5 5 5 5 5 5 5 5 5 5 5 5 5 5 5 5 5 5 5 5 5 5 5 5 5 5 5 5 5 5 5 5 369 367 367 367 24 24 24 24 24 24 24 24 24 3 24 24 24 24 33 32 7 7 7 249 7 7 7 7 7 7 5 7 7 7 7 7 9 1 5 5 5 5 5 5 5 5 5 5 5 5 5 5 5 5 5 5 5 5 5 5 5 5 
5 5 5 5 5 5 5 5 5 5 5 5 5 5 5 5 5 5 5 5 5 5 5 5 5 5 5 5 5 5 5 5 5 5 5 5 5 5 30 34 24 24 367 367 24 24 24 367 367 24 367 367 24 24 24 33 32 5 7 7 7 7 7 7 7 249 7 7 7 7 5 7 7 7 9 9 5 5 5 5 5 5 5 5 5 5 5 5 5 5 5 5 5 5 5 5 5 5 5 5 
5 5 5 5 5 5 5 5 5 5 5 5 5 5 5 5 5 5 5 5 5 5 5 5 5 5 5 5 5 5 5 5 5 5 5 5 5 5 5 28 24 24 24 24 367 367 367 24 24 367 24 24 367 24 33 32 5 5 7 7 7 5 5 7 7 7 7 7 7 5 7 7 7 7 249 9 249 5 5 5 5 5 5 5 5 5 5 5 5 5 5 5 5 5 5 5 5 5 5 5 
5 5 5 5 5 5 5 5 5 5 5 5 5 5 5 5 5 5 5 5 5 5 5 5 5 5 5 5 5 5 5 5 5 5 5 5 5 5 5 28 24 24 24 3 24 24 24 3 24 24 24 24 33 371 32 5 5 5 5 5 5 5 5 5 5 5 5 5 7 7 7 7 7 249 9 9 1 9 5 5 5 5 5 5 5 5 5 5 5 5 5 5 5 5 5 5 5 5 5 5 
5 5 5 5 5 5 5 5 5 5 5 5 5 5 5 5 5 5 5 5 5 5 5 5 5 5 5 5 5 5 5 5 5 5 5 5 5 5 5 28 24 367 24 24 24 24 3 24 24 367 24 33 32 5 5 5 5 5 5 5 5 5 5 5 5 5 5 5 5 7 7 249 249 9 9 9 249 9 5 5 5 5 5 5 5 5 5 5 5 5 5 5 5 5 5 5 5 5 5 5 
5 5 5 5 5 5 5 5 5 5 5 5 5 5 5 5 5 5 5 5 5 5 5 5 5 5 5 5 5 5 5 5 5 5 5 5 5 5 5 30 34 24 24 24 24 367 24 24 24 33 31 32 5 5 5 5 5 5 5 5 5 5 5 5 5 5 5 5 5 5 249 9 9 9 9 9 9 1 5 5 5 5 5 5 5 5 5 5 5 5 5 5 5 5 5 5 5 5 5 5 
5 5 5 5 5 5 5 5 5 5 5 5 5 5 5 5 5 5 5 5 5 5 5 5 5 5 5 5 5 5 5 5 5 5 5 5 5 5 5 5 30 31 31 31 31 31 31 31 31 32 5 5 5 5 5 5 5 5 5 5 5 5 5 5 5 5 5 5 5 5 5 1 9 9 9 9 9 9 5 5 5 5 5 5 5 5 5 5 5 5 5 5 5 5 5 5 5 5 5 5 
5 5 5 5 5 5 5 5 5 5 5 5 5 5 5 5 5 5 5 5 5 5 5 5 5 5 5 5 5 5 5 5 5 5 5 5 5 5 5 5 5 5 5 5 5 5 5 5 5 5 5 5 5 5 5 5 5 5 5 5 5 5 5 5 5 5 5 5 5 5 5 9 249 9 9 9 9 249 5 5 5 5 5 5 5 5 5 5 5 5 5 5 5 5 5 5 5 5 5 5 
5 5 5 5 5 5 5 5 5 5 5 5 5 5 5 5 5 5 5 5 5 5 5 5 5 5 5 5 5 5 5 5 5 5 5 5 5 5 5 5 5 5 5 5 5 5 5 5 5 5 5 5 5 5 5 5 5 5 5 5 5 5 5 5 5 5 5 5 5 5 5 5 9 9 9 9 9 1 5 5 5 5 5 5 5 5 5 5 5 5 5 5 5 5 5 5 5 5 5 5 
5 5 5 5 5 5 5 5 5 5 5 5 5 5 5 5 5 5 5 5 5 5 5 5 5 5 5 5 5 5 5 5 5 5 5 5 5 5 5 5 5 5 5 5 5 5 5 5 5 5 5 5 5 5 5 5 5 5 5 5 5 5 5 5 5 5 5 5 5 5 5 249 9 9 9 9 9 5 5 5 5 5 5 5 5 5 5 5 5 5 5 5 5 5 5 5 5 5 5 5 
5 5 5 5 5 5 5 5 5 5 5 5 5 5 5 5 5 5 5 5 5 5 5 5 5 5 5 5 5 5 5 5 5 5 5 5 5 5 5 5 5 5 5 5 5 5 5 5 5 5 5 5 5 5 5 5 5 5 5 5 5 5 5 5 5 5 5 5 5 5 5 9 9 1 9 9 249 9 5 5 5 5 5 5 5 5 5 5 5 5 5 5 5 5 5 5 5 5 5 5 
5 5 5 5 5 5 5 5 5 5 5 5 5 5 5 5 5 5 5 5 5 5 5 5 5 5 5 5 5 5 5 5 5 5 5 5 5 5 5 5 5 5 5 5 5 5 5 5 5 5 5 5 5 5 5 5 5 5 5 5 5 5 5 5 5 5 5 5 5 5 5 5 9 9 9 9 9 9 9 5 5 5 5 5 5 5 5 5 5 5 5 5 5 5 5 5 5 5 5 5 
5 5 5 5 5 5 5 5 5 5 5 5 5 5 5 5 5 5 5 5 5 5 5 5 5 5 5 5 5 5 5 5 5 5 5 5 5 5 5 5 5 5 5 5 5 5 5 5 5 5 5 5 5 5 5 5 5 5 5 5 5 5 5 5 5 5 5 5 5 5 5 5 9 9 9 9 9 9 1 5 5 5 5 5 5 5 5 5 5 5 5 5 5 5 5 5 5 5 5 5 
5 5 5 5 5 5 5 5 5 5 5 5 5 5 5 5 5 5 5 5 5 5 5 5 5 5 5 5 5 5 5 5 5 5 5 5 5 5 5 5 5 5 5 5 5 5 5 5 5 5 5 5 5 5 5 5 5 5 5 5 5 5 5 5 5 5 5 5 5 5 5 9 249 9 9 9 9 9 249 5 5 5 5 5 5 5 5 5 5 5 5 5 5 5 5 5 5 5 5 5 
5 5 5 5 5 5 5 5 5 5 5 5 5 5 5 5 5 5 5 5 5 5 5 5 5 5 5 5 5 5 5 5 5 5 5 5 5 5 5 5 5 5 5 5 5 5 5 5 5 5 5 5 5 5 5 5 5 5 5 5 5 5 5 5 5 5 5 5 5 5 5 9 9 9 1 9 9 9 5 5 5 5 5 5 5 5 5 5 5 5 5 5 5 5 5 5 5 5 5 5 
5 5 5 5 5 5 5 5 5 5 5 5 5 5 5 5 5 5 5 5 5 5 5 5 5 5 5 5 5 5 5 5 5 5 5 5 5 5 5 5 5 5 5 5 5 5 5 5 5 5 5 5 5 5 5 5 5 5 5 5 5 5 5 5 5 5 5 5 5 5 5 9 9 9 9 9 9 5 5 5 5 5 5 5 5 5 5 5 5 5 5 5 5 5 5 5 5 5 5 5 
5 5 5 5 5 5 5 5 5 5 5 5 5 5 5 5 5 5 5 5 5 5 5 5 5 5 5 5 5 5 5 5 5 5 5 5 5 5 5 5 5 5 5 5 5 5 5 5 5 5 5 5 5 5 5 5 5 5 5 5 5 5 5 5 5 5 5 5 5 5 9 249 1 9 9 9 249 9 1 5 5 5 5 5 5 5 5 5 5 5 5 5 5 5 5 5 5 5 5 5 
5 5 5 5 5 5 5 5 5 5 5 5 5 5 5 5 5 5 5 5 5 5 5 5 5 5 5 5 5 5 5 5 5 5 5 5 5 5 5 5 5 5 5 5 5 5 5 5 5 5 5 5 5 5 5 5 5 5 5 5 5 5 5 5 5 5 5 5 5 5 9 9 9 9 9 9 9 9 9 5 5 5 5 5 5 5 5 5 5 5 5 5 5 5 5 5 5 5 5 5 
5 5 5 5 5 5 5 5 5 5 5 5 5 5 5 5 5 5 5 5 5 5 5 5 5 5 5 5 5 5 5 5 5 5 5 5 5 5 5 5 5 5 5 5 5 5 5 5 5 5 5 5 5 5 5 5 5 5 5 5 5 5 5 5 5 5 5 5 5 5 1 9 9 9 9 9 9 9 249 5 5 5 5 5 5 5 5 5 5 5 5 5 5 5 5 5 5 5 5 5 
5 5 5 5 5 5 5 5 5 5 5 5 5 5 5 5 5 5 5 5 5 5 5 5 5 5 5 5 5 5 5 5 5 5 5 5 5 5 5 5 5 5 5 5 5 5 5 5 5 5 5 5 5 5 5 5 5 5 5 5 5 5 5 5 5 5 5 5 5 5 9 249 9 9 9 9 9 1 5 5 5 5 5 5 5 5 5 5 5 5 5 5 5 5 5 5 5 5 5 5 
5 5 5 5 5 5 5 5 5 5 5 5 5 5 5 5 5 5 5 5 5 5 5 5 5 5 5 5 5 5 5 5 5 5 5 5 5 5 5 5 5 5 5 5 5 5 5 5 5 5 5 5 5 5 5 5 5 5 5 5 5 5 5 5 5 5 5 5 5 5 5 9 9 9 9 9 9 5 5 5 5 5 5 5 5 5 5 5 5 5 5 5 5 5 5 5 5 5 5 5 
5 5 5 5 5 5 5 5 5 5 5 5 5 5 5 5 5 5 5 5 5 5 5 5 5 5 5 5 5 5 5 5 5 5 5 5 5 5 5 5 5 5 5 5 5 5 5 5 5 5 5 5 5 5 5 5 5 5 5 5 5 5 5 5 5 5 5 5 5 5 5 5 5 5 9 5 5 5 5 5 5 5 5 5 5 5 5 5 5 5 5 5 5 5 5 5 5 5 5 5 
5 5 5 5 5 5 5 5 5 5 5 5 5 5 5 5 5 5 5 5 5 5 5 5 5 5 5 5 5 5 5 5 5 5 5 5 5 5 5 5 5 5 5 5 5 5 5 5 5 5 5 5 5 5 5 5 5 5 5 5 5 5 5 5 5 5 5 5 5 5 22 9 9 9 9 9 22 22 22 5 5 5 5 5 5 5 5 5 5 5 5 5 5 5 5 5 5 5 5 5 
5 5 5 5 5 5 5 5 5 5 5 5 5 5 5 5 5 5 5 5 5 5 5 5 5 5 5 5 5 5 5 5 5 5 5 5 5 5 5 5 5 5 5 5 5 5 5 5 5 5 5 5 5 5 5 5 5 5 5 5 5 5 5 5 5 5 5 5 5 22 22 9 9 22 1 9 9 414 9 22 5 5 5 5 5 5 5 5 5 5 5 5 5 5 5 5 5 5 5 5 
5 5 5 5 5 5 5 5 5 5 5 5 5 5 5 5 5 5 5 5 5 5 5 5 5 5 5 5 5 5 5 5 5 5 5 5 5 5 5 5 5 5 5 5 5 5 5 5 5 5 5 5 5 5 5 5 5 5 5 5 5 5 5 5 5 5 5 5 5 22 414 9 9 22 22 9 9 413 9 9 22 5 5 5 5 5 5 5 5 5 5 5 5 5 5 5 5 5 5 5 
5 5 5 5 5 5 5 5 5 5 5 5 5 5 5 5 5 5 5 5 5 5 5 5 5 5 5 5 5 5 5 5 5 5 5 5 5 5 5 5 5 5 5 5 5 5 5 5 5 5 5 5 5 5 5 5 5 5 5 5 5 5 5 5 5 5 5 5 5 22 413 9 18 16 16 16 19 9 22 9 9 5 5 5 5 5 5 5 5 5 5 5 5 5 5 5 5 5 5 5 
5 5 5 5 5 5 5 5 5 5 5 5 5 5 5 5 5 5 5 5 5 5 5 5 5 5 5 5 5 5 5 5 5 5 5 5 5 5 5 5 5 5 5 5 5 5 5 5 5 5 5 5 5 5 5 5 5 5 5 5 5 5 5 5 5 5 5 5 5 22 1 9 14 6 6 6 13 9 9 9 1 5 5 5 5 5 5 5 5 5 5 5 5 5 5 5 5 5 5 5 
5 5 5 5 5 5 5 5 5 5 5 5 5 5 5 5 5 5 5 5 5 5 5 5 5 5 5 5 5 5 5 5 5 5 5 5 5 5 5 5 5 5 5 5 5 5 5 5 5 5 5 5 5 5 5 5 5 5 5 5 5 5 5 5 5 5 5 5 5 9 9 9 14 6 6 6 13 9 1 9 9 5 5 5 5 5 5 140 5 5 5 5 5 5 5 5 5 5 5 5 
5 5 5 5 5 5 5 5 5 5 5 5 5 5 5 5 5 5 5 5 5 5 5 5 5 5 5 5 5 5 5 5 5 5 5 5 5 5 5 5 5 5 5 5 5 5 5 5 5 5 5 5 5 5 5 5 5 5 5 5 5 5 5 5 5 5 5 5 5 9 9 22 14 6 6 6 13 9 9 22 9 5 5 5 5 5 5 143 22 22 22 22 22 22 22 22 22 22 22 22 
5 5 5 5 5 5 5 5 5 5 5 5 5 5 5 5 5 5 5 5 5 5 5 5 5 5 5 5 5 5 5 5 5 5 5 5 5 5 5 5 5 5 5 5 5 5 5 5 5 5 5 5 5 5 5 5 5 5 5 5 146 147 147 147 147 147 148 5 5 1 22 9 14 6 6 6 13 9 9 9 22 5 5 5 5 5 5 143 22 22 22 22 22 22 22 1 22 22 22 22 
5 5 5 5 5 5 5 5 5 5 5 5 5 5 5 5 5 5 5 5 5 5 5 5 5 5 5 5 5 5 5 5 5 5 5 5 5 5 5 5 5 5 5 5 5 5 5 5 5 5 5 5 5 5 5 5 5 5 5 5 149 150 150 150 150 150 151 5 5 9 9 9 14 6 6 6 13 9 1 9 9 5 5 5 5 5 5 143 22 22 22 22 22 22 22 22 22 22 22 22 
5 5 5 5 5 5 5 5 5 5 5 5 5 5 5 5 5 5 5 5 5 5 5 5 5 5 5 5 5 5 5 5 5 5 5 5 5 5 5 5 5 5 5 5 5 5 5 5 5 5 5 5 5 5 5 5 5 5 5 5 149 150 150 150 150 150 151 5 5 5 9 9 14 6 6 6 13 22 9 9 5 5 5 5 5 5 5 143 22 22 22 1 22 22 22 22 22 22 22 22 
5 5 5 5 5 5 5 5 5 5 5 5 5 5 5 5 5 5 5 5 5 5 5 5 5 5 5 5 5 5 5 5 5 5 5 5 5 5 5 5 5 5 5 5 5 5 5 5 5 5 5 5 5 5 5 5 5 5 5 5 152 156 156 153 154 155 157 5 5 5 5 9 14 6 6 6 13 9 9 5 5 5 5 5 5 5 5 143 22 22 22 22 22 22 22 22 22 22 1 22 
5 5 5 5 5 5 5 5 5 5 5 5 5 5 5 5 5 5 5 5 5 5 5 5 5 5 5 5 5 5 5 5 5 5 5 5 5 5 5 5 5 5 5 5 5 5 5 5 5 5 5 5 5 5 5 5 5 5 5 5 158 162 163 159 160 161 164 5 5 5 9 1 14 6 6 6 13 9 9 5 5 5 5 5 5 5 5 143 22 22 1 22 22 22 22 22 22 22 22 22 
5 5 5 5 5 5 5 5 5 5 5 5 5 5 5 5 5 5 5 5 5 5 5 5 5 5 5 5 5 5 5 5 5 5 5 414 5 5 5 5 5 5 5 5 5 5 5 5 5 5 5 5 5 5 5 5 5 5 5 18 16 16 16 17 6 13 9 9 9 9 9 22 14 6 6 6 13 9 9 5 5 5 5 5 5 5 9 143 22 22 22 22 22 1 22 22 22 22 22 22 
5 5 5 5 5 5 5 5 5 5 5 9 1 9 9 9 5 5 5 5 5 5 5 5 5 5 5 5 5 5 5 5 5 5 9 413 1 5 5 5 5 5 5 5 5 5 5 5 5 5 5 5 5 5 5 5 5 5 5 14 6 6 6 6 6 13 1 9 9 22 9 9 14 6 6 6 13 9 165 166 166 166 166 167 5 9 9 143 22 1 22 22 22 22 22 22 22 22 22 22 
5 5 5 5 5 5 5 5 5 5 5 1 9 9 1 9 5 5 5 5 5 5 5 5 5 5 5 5 5 5 5 5 5 1 9 9 9 9 5 5 5 5 5 5 5 5 5 5 5 5 5 5 5 5 5 5 5 5 5 14 6 10 11 11 11 21 9 22 9 9 9 9 14 6 6 6 13 1 168 169 169 169 169 170 9 1 9 143 22 22 22 22 22 22 22 22 1 22 22 22 
5 5 5 5 5 5 5 5 5 5 5 7 7 7 7 7 5 5 5 5 5 5 5 5 5 5 5 5 5 5 5 9 9 7 7 7 7 7 1 9 5 9 9 9 9 9 47 18 16 16 16 16 16 19 5 5 5 5 5 14 6 13 1 22 9 9 9 9 9 9 9 1 14 6 6 6 13 9 171 172 172 172 172 173 9 9 9 143 22 22 22 22 22 22 22 22 22 22 22 22 
5 5 5 5 5 5 5 5 5 5 5 7 7 7 7 7 5 5 5 5 5 5 5 5 5 5 5 5 5 5 5 1 9 7 7 7 7 7 9 9 5 1 9 1 9 9 46 14 6 6 6 6 6 15 19 5 5 5 5 14 6 13 49 50 50 51 1 49 50 50 51 9 14 6 6 6 13 9 174 175 176 177 178 179 1 9 9 143 22 22 22 1 22 22 22 22 22 22 22 22 
5 5 5 5 5 5 5 5 5 5 5 7 7 7 7 7 5 9 9 1 9 9 9 9 9 9 9 7 7 7 7 9 9 5 5 5 5 5 5 5 5 9 9 9 9 9 48 20 11 11 11 12 6 6 15 19 5 5 5 14 6 13 52 53 54 55 9 52 53 54 55 9 14 6 6 6 13 9 180 181 182 183 184 185 9 9 22 143 22 22 22 22 22 22 22 22 22 22 22 22 
5 5 5 5 5 5 5 5 5 5 5 7 7 7 7 7 5 9 9 9 9 9 9 9 1 9 9 7 7 7 7 9 1 5 5 5 7 7 7 7 7 9 9 9 1 9 5 5 9 1 9 20 12 6 6 15 19 5 5 14 6 13 56 57 58 59 9 56 57 58 59 9 14 6 6 6 13 22 9 9 14 6 13 9 9 1 9 143 22 22 22 22 22 22 22 22 22 22 1 22 
5 5 5 5 5 5 5 5 5 5 5 7 7 7 7 7 5 9 5 5 38 39 5 5 5 5 5 5 5 5 5 5 5 5 5 5 7 7 7 7 7 9 9 9 9 9 5 5 1 9 1 9 20 12 6 6 15 16 16 17 6 15 17 6 15 16 16 17 6 15 16 16 17 6 6 6 15 16 16 16 17 6 15 16 16 16 19 143 22 22 22 22 22 22 22 22 22 22 22 22 
5 5 5 5 5 5 5 5 5 5 5 7 7 7 7 7 5 9 9 9 9 9 9 9 9 1 9 7 7 7 7 9 9 7 7 9 9 9 9 5 5 9 1 9 5 5 5 5 9 9 9 9 9 20 12 6 6 6 6 6 6 6 6 6 6 6 6 6 6 6 6 6 6 6 6 6 6 6 6 6 6 6 6 6 6 6 13 143 22 22 22 22 1 22 22 22 22 22 22 22 
5 9 186 187 187 187 187 188 5 5 5 7 7 7 7 7 5 9 1 9 9 1 9 9 9 9 9 7 7 7 7 9 1 7 7 9 9 1 9 5 5 9 9 5 5 5 5 5 5 9 9 9 1 9 14 6 6 6 6 6 6 6 6 6 6 6 6 6 6 6 6 6 6 6 6 6 6 6 6 6 6 6 6 6 6 6 13 143 22 22 22 22 22 22 22 22 1 22 22 22 
9 189 190 191 191 191 191 192 193 9 5 9 9 9 9 9 5 9 9 9 9 9 5 5 5 5 5 5 5 5 5 5 5 7 7 1 9 9 5 5 5 5 5 5 5 5 5 5 5 9 9 9 9 18 17 6 6 6 6 6 6 6 6 6 6 6 6 6 6 6 6 6 6 6 6 6 6 6 6 6 6 6 6 6 6 6 13 143 22 22 1 22 22 22 22 22 22 22 22 22 
16 194 195 196 196 196 196 197 198 19 5 9 9 9 9 9 5 9 9 9 9 9 5 1 9 9 7 7 7 7 7 9 9 7 7 5 5 5 5 7 7 7 7 9 5 5 5 5 9 9 1 9 18 17 6 6 10 11 11 12 6 10 11 11 11 11 11 11 11 11 11 11 12 6 6 6 10 11 11 11 11 11 11 11 11 11 21 143 22 22 22 22 22 22 22 22 22 22 22 22 
6 199 200 201 201 201 201 202 203 13 9 9 9 9 1 9 9 9 9 9 9 9 5 9 1 9 7 7 7 7 7 1 9 7 7 5 5 7 7 7 7 7 7 1 9 5 5 5 9 1 9 18 17 6 6 10 21 9 9 14 6 13 1 22 9 9 9 62 63 64 65 66 14 6 6 6 13 9 22 9 9 1 9 1 9 22 9 143 22 22 1 22 22 22 22 22 22 22 1 22 
11 204 131 206 206 206 206 135 208 21 5 9 9 9 9 9 5 1 1 9 9 9 5 38 37 39 5 5 5 5 5 5 5 5 5 5 7 7 7 7 7 7 9 9 9 9 44 18 16 16 16 17 6 6 10 21 5 5 1 14 6 13 82 83 84 85 1 67 68 69 70 71 14 6 6 6 13 9 9 49 50 50 51 9 22 9 9 143 22 22 22 22 22 1 22 22 22 22 22 22 
5 5 5 5 5 5 5 5 9 9 5 9 9 9 1 9 5 1 9 9 9 9 5 9 9 9 9 7 7 7 7 7 9 5 7 7 7 7 7 7 7 9 9 9 1 9 43 14 6 6 6 6 6 10 21 5 5 5 9 14 6 13 86 87 88 89 22 72 73 74 75 76 14 6 6 6 13 1 9 52 53 54 55 9 9 9 9 143 22 22 22 22 22 22 22 22 22 22 22 22 
5 5 5 5 5 5 5 5 5 5 5 5 5 5 5 5 5 5 38 37 37 39 5 9 9 9 1 7 7 7 7 7 9 5 7 7 7 7 7 7 9 1 9 9 9 9 45 20 11 11 11 11 11 21 5 5 5 5 22 14 6 13 90 91 92 93 9 77 78 79 80 81 14 6 6 6 13 9 1 56 57 58 59 1 9 22 5 143 22 22 22 22 22 22 22 22 22 22 22 22 
5 5 5 5 5 5 5 5 5 9 9 7 7 7 7 7 7 7 9 9 9 9 5 9 1 9 9 7 7 7 7 7 1 5 7 7 7 9 1 9 9 9 9 5 5 5 5 5 9 1 5 5 5 5 5 5 5 5 9 14 6 15 16 17 6 15 16 16 17 6 15 16 17 6 6 6 15 16 16 17 6 13 9 9 9 9 5 143 22 22 1 22 22 22 22 22 22 22 22 22 
5 5 5 5 5 5 5 5 5 1 9 7 7 7 7 7 7 7 9 1 9 9 44 9 9 9 9 7 7 7 7 7 9 44 7 7 9 9 9 5 38 39 5 5 5 9 9 44 9 9 5 5 5 5 5 5 5 5 1 14 6 6 6 6 6 6 6 6 6 6 6 6 6 6 6 6 6 6 6 6 6 13 22 9 5 9 5 143 22 22 22 22 22 1 22 22 22 22 22 22 
5 5 5 5 5 5 5 5 5 9 9 7 7 7 7 7 7 7 9 9 1 9 43 9 9 1 9 7 7 7 7 7 9 45 9 9 1 9 9 44 9 9 9 9 9 9 1 45 9 5 5 5 5 5 5 5 5 5 5 20 11 12 6 10 11 11 11 11 11 11 11 11 12 6 6 6 10 11 11 11 11 21 9 9 5 9 9 143 22 22 22 22 22 22 22 22 22 22 22 22 
5 5 5 5 5 5 5 5 5 9 9 7 7 7 7 7 7 7 9 9 9 9 45 9 9 9 9 7 7 7 7 7 9 5 9 9 9 9 1 45 9 9 9 1 9 9 9 5 5 5 5 5 5 5 5 5 5 5 5 5 9 14 6 13 146 147 147 147 147 147 148 1 14 6 6 6 13 9 22 9 1 22 9 9 5 1 22 143 22 22 22 1 22 22 22 22 22 22 22 22 
5 5 5 5 5 5 5 5 5 5 5 5 9 414 1 9 5 5 5 5 5 5 5 5 5 5 5 5 5 5 5 5 5 5 9 1 9 5 5 5 41 42 5 5 5 1 9 5 5 5 5 5 5 5 5 5 5 5 5 5 5 14 6 13 149 150 150 150 150 150 151 9 14 6 6 6 13 9 1 9 678 679 679 679 680 5 9 143 22 22 22 22 22 22 22 22 22 22 22 22 
5 5 5 5 5 5 5 5 5 5 5 5 1 413 9 1 5 5 5 5 5 5 5 5 5 5 5 5 5 5 5 5 5 5 5 5 5 5 5 5 9 1 5 5 5 5 9 5 5 5 5 5 5 5 5 5 5 5 5 5 5 14 6 13 149 150 150 150 150 150 151 9 14 6 6 6 13 9 9 9 681 682 682 682 683 22 1 142 139 139 139 139 139 139 139 139 139 139 139 139 
5 5 5 5 5 5 5 5 5 5 5 5 5 1 9 5 5 5 5 5 5 5 5 5 5 5 5 5 5 5 5 5 5 5 5 5 5 5 5 5 1 9 9 414 9 9 9 5 5 5 5 5 5 5 5 5 5 5 5 5 5 14 6 13 152 153 154 155 156 156 157 22 14 6 6 6 13 1 9 9 684 685 685 685 686 9 9 9 5 5 5 5 5 5 5 5 5 5 5 5 
5 5 5 5 5 5 5 5 5 5 5 5 5 9 5 5 5 5 5 5 5 5 5 5 5 5 5 5 5 5 5 5 5 5 5 5 5 5 5 5 5 9 9 413 1 9 1 5 5 5 5 5 5 5 5 5 5 5 5 5 5 14 6 13 158 159 160 161 162 163 164 1 14 6 6 6 13 22 1 9 687 688 689 690 691 1 9 9 9 5 5 5 5 5 5 5 5 5 5 5 
5 5 5 5 5 5 5 5 5 5 5 5 5 5 5 5 5 5 5 5 5 5 5 5 5 5 5 5 5 5 5 5 5 5 5 5 5 5 5 5 5 9 1 9 9 9 5 5 5 5 5 5 5 5 5 5 5 5 5 5 5 14 6 15 16 17 6 13 5 5 5 9 14 6 6 6 15 16 16 16 17 6 13 9 22 47 9 1 22 5 5 5 5 5 5 5 5 5 5 5 
5 5 5 5 5 5 5 5 5 5 5 5 5 5 5 5 5 5 5 5 5 5 5 5 5 5 5 5 5 5 5 5 5 5 5 5 5 5 5 5 5 5 9 9 1 5 5 5 5 5 5 5 5 5 5 5 5 5 5 5 5 14 6 6 6 6 6 13 5 5 5 5 14 6 6 6 6 6 6 6 6 6 13 1 9 48 22 9 5 5 5 5 5 5 5 5 5 5 5 5 
5 5 5 5 5 5 5 5 5 5 5 5 5 5 5 5 5 5 5 5 5 5 5 5 5 5 5 5 5 5 5 5 5 5 5 5 5 5 5 5 5 5 5 5 5 5 5 5 5 5 5 5 5 5 5 5 5 5 5 5 5 20 11 11 11 11 11 21 5 5 5 5 20 12 6 10 11 11 11 11 11 11 21 9 9 5 5 5 5 5 5 5 5 5 5 5 5 5 5 5 
5 5 5 5 5 5 5 5 5 5 5 5 5 5 5 5 5 5 5 5 5 5 5 5 5 5 5 5 5 5 5 5 5 5 5 5 5 5 5 5 5 5 5 5 5 5 5 5 5 5 5 5 5 5 5 5 5 5 5 5 5 5 5 5 5 5 5 5 5 5 5 5 9 14 6 13 1 22 1 9 22 9 1 9 5 5 5 5 5 5 5 5 5 5 5 5 5 5 5 5 
5 5 5 5 5 5 5 5 5 5 5 5 5 5 5 5 5 5 5 5 5 5 5 5 5 5 5 5 5 5 5 5 5 5 5 5 5 5 5 5 5 5 5 5 5 5 5 5 5 5 5 5 5 5 5 5 5 5 5 5 5 5 5 5 5 5 5 5 5 5 5 5 1 114 115 116 9 5 5 5 5 5 5 5 5 5 5 5 5 5 5 5 5 5 5 5 5 5 5 5 
5 5 5 5 5 5 5 5 5 5 5 5 5 5 5 5 5 5 5 5 5 5 5 5 5 5 5 5 5 5 5 5 5 5 5 5 5 5 5 5 5 5 5 5 5 5 5 5 5 5 5 5 5 5 5 5 5 5 5 5 5 5 5 5 5 5 5 5 5 5 5 5 186 117 118 119 188 5 5 5 5 5 5 5 5 5 5 5 5 5 5 5 5 5 5 5 5 5 5 5 
5 5 5 5 5 5 5 5 5 5 5 5 5 5 5 5 5 5 5 5 5 5 5 5 5 5 5 5 5 5 5 5 5 5 5 5 5 5 5 5 5 5 5 5 5 5 5 5 5 5 5 5 5 5 5 5 5 5 5 5 5 5 5 5 5 5 5 5 5 5 5 5 190 191 191 191 192 5 5 5 5 5 5 5 5 5 5 5 5 5 5 5 5 5 5 5 5 5 5 5 
5 5 5 5 5 5 5 5 5 5 5 5 5 5 5 5 5 5 5 5 5 5 5 5 5 5 5 5 5 5 5 5 5 5 5 5 5 5 5 5 5 5 5 5 5 5 5 5 5 5 5 5 5 5 5 5 5 5 5 5 5 5 5 5 5 5 5 5 5 5 5 5 195 196 196 196 197 5 5 5 5 5 5 5 5 5 5 5 5 5 5 5 5 5 5 5 5 5 5 5 
5 5 5 5 5 5 5 5 5 5 5 5 5 5 5 5 5 5 5 5 5 5 5 5 5 5 5 5 5 5 5 5 5 5 5 5 5 5 5 5 5 5 5 5 5 5 5 5 5 5 5 5 5 5 5 5 5 5 5 5 5 5 5 5 5 5 5 5 5 5 5 5 126 127 128 129 130 5 5 5 5 5 5 5 5 5 5 5 5 5 5 5 5 5 5 5 5 5 5 5 
5 5 5 5 5 5 5 5 5 5 5 5 5 5 5 5 5 5 5 5 5 5 5 5 5 5 5 5 5 5 5 5 5 5 5 5 5 5 5 5 5 5 5 5 5 5 5 5 5 5 5 5 5 5 5 5 5 5 5 5 5 5 5 5 5 5 5 5 5 5 5 5 131 132 133 134 135 5 5 5 5 5 5 5 5 5 5 5 5 5 5 5 5 5 5 5 5 5 5 5 
5 5 5 5 5 5 5 5 5 5 5 5 5 5 5 5 5 5 5 5 5 5 5 5 5 5 5 5 5 5 5 5 5 5 5 5 5 5 5 5 5 5 5 5 5 5 5 5 5 5 5 5 5 5 5 5 5 5 5 5 5 5 5 5 5 5 5 5 5 5 5 5 9 136 137 138 9 5 5 5 5 5 5 5 5 5 5 5 5 5 5 5 5 5 5 5 5 5 5 5 
5 5 5 5 5 5 5 5 5 5 5 5 5 5 5 5 5 5 5 5 5 5 5 5 5 5 5 5 5 5 5 5 5 5 5 5 5 5 5 5 5 5 5 5 5 5 5 5 5 5 5 5 5 5 5 5 5 5 5 5 5 5 5 5 5 5 5 5 5 5 5 5 5 14 6 13 5 5 5 5 5 5 5 5 5 5 5 5 5 5 5 5 5 5 5 5 5 5 5 5 
5 5 5 5 5 5 5 5 5 5 5 5 5 5 5 5 5 5 5 5 5 5 5 5 5 5 5 5 5 5 5 5 5 5 5 5 5 5 5 5 5 5 5 5 5 5 5 5 5 5 5 5 5 5 5 5 5 5 5 5 5 5 5 5 5 5 5 5 5 5 5 5 5 14 6 13 5 5 5 5 5 5 5 5 5 5 5 5 5 5 5 5 5 5 5 5 5 5 5 5 
5 5 5 5 5 5 5 5 5 5 5 5 5 5 5 5 5 5 5 5 5 5 5 5 5 5 5 5 5 5 5 5 5 5 5 5 5 5 5 5 5 5 5 5 5 5 5 5 5 5 5 5 5 5 5 5 5 5 5 5 5 5 5 5 5 5 5 5 5 5 5 5 5 14 6 13 5 5 5 5 5 5 5 5 5 5 5 5 5 5 5 5 5 5 5 5 5 5 5 5 
5 5 5 5 5 5 5 5 5 5 5 5 5 5 5 5 5 5 5 5 5 5 5 5 5 5 5 5 5 5 5 5 5 5 5 5 5 5 5 5 5 5 5 5 5 5 5 5 5 5 5 5 5 5 5 5 5 5 5 5 5 5 5 5 5 5 5 5 5 5 5 5 5 5 5 5 5 5 5 5 5 5 5 5 5 5 5 5 5 5 5 5 5 5 5 5 5 5 5 5 
5 5 5 5 5 5 5 5 5 5 5 5 5 5 5 5 5 5 5 5 5 5 5 5 5 5 5 5 5 5 5 5 5 5 5 5 5 5 5 5 5 5 5 5 5 5 5 5 5 5 5 5 5 5 5 5 5 5 5 5 5 5 5 5 5 5 5 5 5 5 5 5 5 5 5 5 5 5 5 5 5 5 5 5 5 5 5 5 5 5 5 5 5 5 5 5 5 5 5 5 
5 5 5 5 5 5 5 5 5 5 5 5 5 5 5 5 5 5 5 5 5 5 5 5 5 5 5 5 5 5 5 5 5 5 5 5 5 5 5 5 5 5 5 5 5 5 5 5 5 5 5 5 5 5 5 5 5 5 5 5 5 5 5 5 5 5 5 5 5 5 5 5 5 5 5 5 5 5 5 5 5 5 5 5 5 5 5 5 5 5 5 5 5 5 5 5 5 5 5 5 
5 5 5 5 5 5 5 5 5 5 5 5 5 5 5 5 5 5 5 5 5 5 5 5 5 5 5 5 5 5 5 5 5 5 5 5 5 5 5 5 5 5 5 5 5 5 5 5 5 5 5 5 5 5 5 5 5 5 5 5 5 5 5 5 5 5 5 5 5 5 5 5 5 5 5 5 5 5 5 5 5 5 5 5 5 5 5 5 5 5 5 5 5 5 5 5 5 5 5 5 
5 5 5 5 5 5 5 5 5 5 5 5 5 5 5 5 5 5 5 5 5 5 5 5 5 5 5 5 5 5 5 5 5 5 5 5 5 5 5 5 5 5 5 5 5 5 5 5 5 5 5 5 5 5 5 5 5 5 5 5 5 5 5 5 5 5 5 5 5 5 5 5 5 5 5 5 5 5 5 5 5 5 5 5 5 5 5 5 5 5 5 5 5 5 5 5 5 5 5 5 
5 5 5 5 5 5 5 5 5 5 5 5 5 5 5 5 5 5 5 5 5 5 5 5 5 5 5 5 5 5 5 5 5 5 5 5 5 5 5 5 5 5 5 5 5 5 5 5 5 5 5 5 5 5 5 5 5 5 5 5 5 5 5 5 5 5 5 5 5 5 5 5 5 5 5 5 5 5 5 5 5 5 5 5 5 5 5 5 5 5 5 5 5 5 5 5 5 5 5 5 
