5 5 5 5 5 5 5 5 5 28 24 3 24 367 24 24 24 24 29 5 5 14 6 6 13 5 5 5 5 5 5 5 5 5 5 5 5 5 5 5 5 5 5 5 5 5 5 5 5 5 5 5 5 5 5 5 5 5 5 5 5 5 5 5 5 5 5 5 5 5 5 5 5 5 5 5 5 5 5 5 5 5 5 5 5 5 5 5 5 5 5 5 5 5 5 5 5 5 5 5 
5 5 5 5 5 5 5 5 25 36 24 24 24 24 24 367 24 3 29 5 5 14 6 10 21 5 5 5 5 5 5 5 5 5 5 5 5 5 5 5 5 5 5 5 5 5 5 5 5 5 5 5 5 5 5 5 5 5 5 5 5 5 5 5 5 5 5 5 5 5 5 5 5 5 5 5 5 5 5 5 5 5 5 5 5 5 5 5 5 5 5 5 5 5 5 5 5 5 5 5 
5 5 5 5 5 5 5 5 28 24 24 367 24 24 24 24 24 24 29 5 5 14 6 13 5 5 5 5 5 5 5 5 5 5 5 5 5 5 5 5 5 5 5 5 5 5 5 5 5 5 5 5 5 5 5 5 5 5 5 5 5 5 5 5 5 5 5 5 5 5 5 5 5 5 5 5 5 5 5 5 5 5 5 5 5 5 5 5 5 5 5 5 5 5 5 5 5 5 5 5 
5 5 5 5 5 5 5 5 369 24 24 24 24 24 3 24 24 367 29 5 5 114 115 116 5 5 5 5 5 5 5 5 5 5 5 5 5 5 5 5 5 5 5 5 5 5 5 5 5 5 5 5 5 5 5 5 5 5 5 5 5 5 5 5 5 5 5 5 5 5 5 5 5 5 5 5 5 5 5 5 5 5 5 5 5 5 5 5 5 5 5 5 5 5 5 5 5 5 5 5 
5 5 5 5 5 5 5 25 36 24 24 24 24 24 3 24 24 33 32 5 117 118 118 118 119 5 5 5 5 5 5 5 5 5 5 5 5 5 5 5 5 5 5 5 5 5 5 5 5 5 5 5 5 5 5 5 5 5 5 5 5 5 5 5 5 5 5 5 5 5 5 5 5 5 5 5 5 5 5 5 5 5 5 5 5 5 5 5 5 5 5 5 5 5 5 5 5 5 5 5 
5 5 5 5 5 5 5 28 24 24 3 24 24 24 367 24 24 29 5 5 120 121 121 121 122 5 5 5 5 5 5 5 5 5 5 5 5 5 5 5 5 5 5 5 5 5 5 5 5 5 5 5 5 5 5 5 5 5 5 5 5 5 5 5 5 5 5 5 5 5 5 5 5 5 5 5 5 5 5 5 5 5 5 5 5 5 5 5 5 5 5 5 5 5 5 5 5 5 5 5 
5 5 5 5 5 5 5 369 24 24 24 24 24 24 24 24 3 35 27 5 123 124 124 124 125 5 5 5 5 5 5 5 5 5 5 5 5 5 5 5 5 5 5 5 5 5 5 5 5 5 5 5 5 5 5 5 5 5 5 5 5 5 5 5 5 5 5 5 5 5 5 5 5 5 5 5 5 5 5 5 5 5 5 5 5 5 5 5 5 5 5 5 5 5 5 5 5 5 5 5 
5 5 5 5 5 5 5 28 24 24 24 367 24 24 24 24 24 24 35 27 126 127 128 129 130 5 5 5 5 5 5 5 5 5 5 5 5 5 5 5 5 5 5 5 5 5 5 5 5 5 5 5 5 5 5 5 5 5 5 5 5 5 5 5 5 5 5 5 5 5 5 5 5 5 5 5 5 5 5 5 5 5 5 5 5 5 5 5 5 5 5 5 5 5 5 5 5 5 5 5 
5 5 5 5 5 5 5 28 24 24 24 24 24 24 24 24 367 24 24 29 131 132 133 134 135 5 5 5 5 5 5 5 5 5 5 5 5 5 5 5 5 5 5 5 5 5 5 5 5 5 5 5 5 5 5 5 5 5 5 5 5 5 5 5 5 5 5 5 5 5 5 5 5 5 5 5 5 5 5 5 5 5 5 5 5 5 5 5 5 5 5 5 5 5 5 5 5 5 5 5 
5 5 5 5 5 5 5 369 24 24 24 24 24 24 3 24 24 24 24 370 9 136 137 138 9 5 5 5 5 5 5 5 5 5 5 5 5 5 5 5 5 5 5 5 5 5 5 5 5 5 5 5 5 5 5 5 5 5 5 5 5 5 5 5 5 5 5 5 5 5 5 5 5 5 5 5 5 5 5 5 5 5 5 5 5 5 5 5 5 5 5 5 5 5 5 5 5 5 5 5 
5 5 5 5 5 5 5 28 367 3 24 367 24 24 367 24 24 367 367 29 9 14 6 13 9 9 5 5 5 5 5 5 5 5 5 5 5 5 5 5 5 5 5 5 5 5 5 5 5 5 5 5 5 5 5 5 5 5 5 5 5 5 5 5 5 5 5 5 5 5 5 5 5 5 5 5 5 5 5 5 5 5 5 5 5 5 5 5 5 5 5 5 5 5 5 5 5 5 5 5 
5 5 5 5 5 5 5 30 34 367 367 24 367 367 24 367 367 24 24 29 9 20 11 21 9 9 5 5 5 5 5 5 5 5 5 5 5 5 5 5 5 5 5 5 5 5 5 5 5 5 5 5 5 5 5 5 5 5 5 5 5 5 5 5 5 5 5 5 5 5 5 5 5 5 5 5 5 5 5 5 5 5 5 5 5 5 5 5 5 5 5 5 5 5 5 5 5 5 5 5 
5 5 5 5 5 5 5 5 30 24 24 24 24 24 24 24 24 24 24 35 27 9 9 9 9 9 5 5 5 5 5 5 5 5 5 5 5 5 5 5 5 5 5 5 5 5 5 5 5 5 5 5 5 5 5 5 5 5 5 5 5 5 5 5 5 5 5 5 5 5 5 5 5 5 5 5 5 5 5 5 5 5 5 5 5 5 5 5 5 5 5 5 5 5 5 5 5 5 5 5 
5 5 5 5 5 5 5 5 5 28 24 24 367 24 24 24 24 24 367 24 35 26 26 368 27 5 5 5 5 5 5 5 5 5 5 5 5 5 5 5 5 5 5 5 5 5 5 5 5 5 5 5 5 5 5 5 5 5 5 5 5 5 5 5 5 5 5 5 5 5 5 5 5 5 5 5 5 5 5 5 5 5 5 5 5 5 5 5 5 5 5 5 5 5 5 5 5 5 5 5 
5 5 5 5 5 5 5 5 5 369 24 33 31 34 24 367 24 24 24 24 24 24 24 24 35 27 5 5 5 5 5 5 5 5 5 5 5 5 5 5 5 5 5 5 5 5 5 5 5 5 5 5 5 5 5 5 5 5 5 5 5 5 5 5 5 5 5 5 5 5 5 5 5 5 5 5 5 5 5 5 5 5 5 5 5 5 5 5 5 5 5 5 5 5 5 5 5 5 5 5 
5 5 5 5 5 5 5 5 5 28 24 29 9 28 24 24 24 24 24 24 24 367 24 24 24 35 27 5 5 5 5 5 5 5 5 5 5 5 5 5 5 5 5 5 5 5 5 5 5 5 5 5 5 5 5 5 5 5 5 5 5 5 5 5 5 5 5 5 5 5 5 5 5 5 5 5 5 5 5 5 5 5 5 5 5 5 5 5 5 5 5 5 5 5 5 5 5 5 5 5 
5 5 5 5 5 5 5 5 5 28 24 35 26 36 24 24 24 24 367 24 24 24 24 24 24 24 370 5 5 5 5 5 5 5 5 5 5 5 5 5 5 5 5 5 5 5 5 5 5 5 5 5 5 5 5 5 5 5 5 5 5 5 5 5 5 5 5 5 5 5 5 5 5 5 5 5 5 5 5 5 5 5 5 5 5 5 5 5 5 5 5 5 5 5 5 5 5 5 5 5 
5 5 5 5 5 5 5 5 5 28 24 367 24 24 367 24 24 24 24 24 24 24 24 367 24 24 29 5 5 5 5 5 5 5 5 5 5 5 5 5 5 5 5 5 5 5 5 5 5 5 5 5 5 5 5 5 5 5 5 5 5 5 5 5 5 5 5 5 5 5 5 5 5 5 5 5 5 5 5 5 5 5 5 5 5 5 5 5 5 5 5 5 5 5 5 5 5 5 5 5 
5 5 5 5 5 5 5 5 5 369 24 24 24 24 24 24 24 24 24 367 24 24 24 24 24 33 32 9 5 5 5 5 5 5 5 5 5 5 5 5 5 5 5 5 5 5 5 5 5 5 5 5 5 5 5 5 5 5 5 5 5 5 5 5 5 5 5 5 5 5 5 5 5 5 5 5 5 5 5 5 5 5 5 5 5 5 5 5 5 5 5 5 5 5 5 5 5 5 5 5 
5 5 5 5 5 5 5 5 5 30 24 24 367 24 24 24 24 24 24 24 24 367 24 24 33 32 9 9 5 5 5 5 5 5 5 5 5 5 5 5 5 5 5 5 5 5 5 5 5 5 5 5 5 5 5 5 5 5 5 5 5 5 5 5 5 5 5 5 5 5 5 5 5 5 5 5 5 5 5 5 5 5 5 5 5 5 5 5 5 5 5 5 5 5 5 5 5 5 5 5 
5 5 5 5 5 5 5 5 5 5 28 24 24 24 24 24 367 24 24 24 24 24 24 33 32 5 9 9 5 5 5 5 5 5 5 5 5 5 5 5 5 5 5 5 5 5 5 5 5 5 5 5 5 5 5 5 5 5 5 5 5 5 5 5 5 5 5 5 5 5 5 5 5 5 5 5 5 5 5 5 5 5 5 5 5 5 5 5 5 5 5 5 5 5 5 5 5 5 5 5 
5 5 5 5 5 5 5 5 5 5 28 24 24 24 367 24 24 24 24 24 24 24 33 32 5 4 9 9 5 5 5 5 5 5 5 5 5 5 5 5 5 5 5 5 5 5 5 5 5 5 5 5 5 5 5 5 5 5 5 5 5 5 5 5 5 5 5 5 5 5 5 5 5 5 5 5 5 5 5 5 5 5 5 5 5 5 5 5 5 5 5 5 5 5 5 5 5 5 5 5 
5 5 5 5 5 5 5 5 5 5 28 24 24 24 24 24 24 4 367 24 24 24 29 5 5 7 7 7 5 5 5 5 5 5 5 5 5 5 5 5 5 5 5 5 5 5 5 5 5 5 5 5 5 5 5 5 5 5 5 5 5 5 5 5 5 5 5 5 5 5 5 5 5 5 5 5 5 5 5 5 5 5 5 5 5 5 5 5 5 5 5 5 5 5 5 5 5 5 5 5 
5 5 5 5 5 5 5 5 5 5 28 24 367 24 24 24 24 367 24 24 24 24 370 9 5 7 7 7 5 5 5 5 5 5 5 5 5 5 5 5 5 5 5 5 5 5 5 5 5 5 5 5 5 5 5 5 5 5 5 5 5 5 5 5 5 5 5 5 5 5 5 5 5 5 5 5 5 5 5 5 5 5 5 5 5 5 5 5 5 5 5 5 5 5 5 5 5 5 5 5 
5 5 5 5 5 5 5 5 5 5 369 24 24 24 24 24 24 24 367 24 24 24 29 9 4 7 7 7 5 5 5 5 5 5 5 5 5 5 5 5 5 5 5 5 5 5 5 5 5 5 5 5 5 5 5 5 5 5 5 5 5 5 5 5 5 5 5 5 5 5 5 5 5 5 5 5 5 5 5 5 5 5 5 5 5 5 5 5 5 5 5 5 5 5 5 5 5 5 5 5 
5 5 5 5 5 5 5 5 5 5 28 367 367 24 367 367 24 24 367 24 24 24 29 5 9 7 7 7 5 5 5 5 5 5 5 5 5 5 5 5 5 5 5 5 5 5 5 5 5 5 5 5 5 5 5 5 5 5 5 5 5 5 5 5 5 5 5 5 5 5 5 5 5 5 5 5 5 5 5 5 5 5 5 5 5 5 5 5 5 5 5 5 5 5 5 5 5 5 5 5 
5 5 5 5 5 5 5 5 5 5 28 24 33 371 34 24 367 24 24 367 24 24 35 27 5 5 7 7 5 5 5 5 5 5 5 5 5 5 5 5 5 5 5 5 5 5 5 5 5 5 5 5 5 5 5 5 5 5 5 5 5 5 5 5 5 5 5 5 5 5 5 5 5 5 5 5 5 5 5 5 5 5 5 5 5 5 5 5 5 5 5 5 5 5 5 5 5 5 5 5 
5 5 5 5 5 5 5 5 5 5 30 34 29 9 28 24 367 24 24 367 24 24 24 4 26 27 5 5 5 5 5 5 5 5 5 5 5 5 5 5 5 5 5 5 5 5 5 5 5 5 5 5 5 5 5 5 5 5 5 5 5 5 5 5 5 5 5 5 5 5 5 5 5 5 5 5 5 5 5 5 5 5 5 5 5 5 5 5 5 5 5 5 5 5 5 5 5 5 5 5 
5 5 5 5 5 5 5 5 5 5 5 28 35 26 36 24 24 367 367 24 24 24 24 24 24 35 368 27 5 5 5 5 5 5 5 5 5 5 5 5 5 5 5 5 5 5 5 5 5 5 5 5 5 5 5 5 5 5 5 5 5 5 5 5 5 5 5 5 5 5 5 5 5 5 5 5 5 5 5 5 5 5 5 5 5 5 5 5 5 5 5 5 5 5 5 5 5 5 5 5 
5 5 5 5 5 5 5 5 5 5 5 28 24 24 24 24 33 371 34 24 24 24 24 24 24 24 33 32 5 5 5 5 5 5 5 5 5 5 5 5 5 5 5 5 5 5 5 5 5 5 5 5 5 5 5 5 5 5 5 5 5 5 5 5 5 5 5 5 5 5 5 5 5 5 5 5 5 5 5 5 5 5 5 5 5 5 5 5 5 5 5 5 5 5 5 5 5 5 5 5 
5 5 5 5 5 5 5 5 5 5 5 28 24 24 4 33 32 9 30 34 24 24 24 24 33 31 32 5 5 5 5 5 5 5 5 5 5 5 5 5 5 5 5 5 5 5 5 5 5 5 5 5 5 5 5 5 5 5 5 5 5 5 5 5 5 5 5 5 5 5 5 5 5 5 5 5 5 5 5 5 5 5 5 5 5 5 5 5 5 5 5 5 5 5 5 5 5 5 5 5 
5 5 5 5 5 5 5 5 5 5 5 28 24 24 33 32 9 5 9 28 24 24 24 33 32 5 5 5 5 5 5 5 5 5 5 5 5 5 5 5 5 5 5 5 5 5 5 5 5 5 5 5 5 5 5 5 5 5 5 5 5 5 5 5 5 5 5 5 5 5 5 5 5 5 5 5 5 5 5 5 5 5 5 5 5 5 5 5 5 5 5 5 5 5 5 5 5 5 5 5 
5 5 5 5 5 5 5 5 5 5 5 28 24 24 29 4 9 9 5 28 24 24 4 32 5 5 5 5 5 5 5 5 5 5 5 5 5 5 5 5 5 5 5 5 5 5 5 5 5 5 5 5 5 5 5 5 5 5 5 5 5 5 5 5 5 5 5 5 5 5 5 5 5 5 5 5 5 5 5 5 5 5 5 5 5 5 5 5 5 5 5 5 5 5 5 5 5 5 5 5 
5 5 5 5 5 5 5 5 5 5 25 36 24 24 35 27 9 5 25 36 24 24 29 5 5 5 5 5 5 5 5 5 5 5 5 5 5 5 5 5 5 5 5 5 5 5 5 5 5 5 5 5 5 5 5 5 5 5 5 5 5 5 5 5 5 5 5 5 5 5 5 5 5 5 5 5 5 5 5 5 5 5 5 5 5 5 5 5 5 5 5 5 5 5 5 5 5 5 5 5 
5 5 5 5 5 5 5 5 5 5 28 24 24 24 24 35 26 26 36 24 24 24 29 5 5 5 5 5 5 5 5 5 5 5 5 5 5 5 5 5 5 5 5 5 5 5 5 5 5 5 5 5 5 5 5 5 5 5 5 5 5 5 5 5 5 5 5 5 5 5 5 5 5 5 5 5 5 5 5 5 5 5 5 5 5 5 5 5 5 5 5 5 5 5 5 5 5 5 5 5 
5 5 5 5 5 5 5 5 5 5 28 24 24 24 24 24 24 24 24 24 24 24 35 27 5 5 5 5 5 5 5 5 5 5 5 5 5 5 5 5 5 5 5 5 5 5 5 5 5 5 5 5 5 5 5 5 5 5 5 5 5 5 5 5 5 5 5 5 5 5 5 5 5 5 5 5 5 5 5 5 5 5 5 5 5 5 5 5 5 5 5 5 5 5 5 5 5 5 5 5 
5 5 5 5 5 5 5 5 5 25 36 24 24 24 24 24 24 24 24 24 24 24 24 35 27 5 5 5 5 5 5 5 5 5 5 5 5 5 5 5 5 5 5 5 5 5 5 5 5 5 5 5 5 5 5 5 5 5 5 5 5 5 5 5 5 5 5 5 5 5 5 5 5 5 5 5 5 5 5 5 5 5 5 5 5 5 5 5 5 5 5 5 5 5 5 5 5 5 5 5 
5 5 5 5 5 5 5 5 5 28 24 24 24 24 24 24 24 24 24 24 24 24 24 24 35 27 5 5 5 5 5 5 5 5 5 5 5 5 5 5 5 5 5 5 5 5 5 5 5 5 5 5 5 5 5 5 5 5 5 5 5 5 5 5 5 5 5 5 5 5 5 5 5 5 5 5 5 5 5 5 5 5 5 5 5 5 5 5 5 5 5 5 5 5 5 5 5 5 5 5 
5 5 5 5 5 5 5 5 5 28 24 24 24 24 24 24 24 24 24 24 24 24 24 24 24 29 5 5 5 5 5 5 5 5 5 5 5 5 5 5 5 5 5 5 5 5 5 5 5 5 5 5 5 5 5 5 5 5 5 5 5 5 5 5 5 5 5 5 5 5 5 5 5 5 5 5 5 5 5 5 5 5 5 5 5 5 5 5 5 5 5 5 5 5 5 5 5 5 5 5 
5 5 5 5 5 5 5 5 5 28 24 24 24 24 24 24 4 24 24 24 24 24 24 24 33 32 5 5 5 5 5 5 5 5 5 5 5 5 5 5 5 5 5 5 5 5 5 5 5 5 5 5 5 5 5 5 5 5 5 5 5 5 5 5 5 5 5 5 5 5 5 5 5 5 5 5 5 5 5 5 5 5 5 5 5 5 5 5 5 5 5 5 5 5 5 5 5 5 5 5 
5 5 5 5 5 5 5 5 9 30 24 24 24 24 24 24 24 24 24 24 24 24 24 33 32 5 5 5 5 5 5 5 5 5 5 5 5 5 5 5 5 5 5 5 5 5 5 5 5 5 5 5 5 5 5 5 5 5 5 5 5 5 5 5 5 5 5 5 5 5 5 5 5 5 5 5 5 5 5 5 5 5 5 5 5 5 5 5 5 5 5 5 5 5 5 5 5 5 5 5 
5 5 5 5 5 5 5 5 9 9 30 31 24 24 24 24 24 367 367 24 24 33 31 32 9 5 5 5 5 5 5 5 5 5 5 5 5 5 5 5 5 5 5 5 5 5 5 5 5 5 5 5 5 5 5 5 5 5 5 5 5 5 5 5 5 5 5 5 5 5 5 5 5 5 5 5 5 5 5 5 5 5 5 5 5 5 5 5 5 5 5 5 5 5 5 5 5 5 5 5 
5 5 5 5 5 5 5 5 5 9 9 9 30 24 24 367 367 24 24 367 367 370 9 9 9 5 5 5 5 5 5 5 5 5 5 5 5 5 5 5 5 5 5 5 5 5 5 5 5 5 5 5 5 5 5 5 5 5 5 5 5 5 5 5 5 5 5 5 5 5 5 5 5 5 5 5 5 5 5 5 5 5 5 5 5 5 5 5 5 5 5 5 5 5 5 5 5 5 5 5 
5 5 5 5 5 5 5 5 5 9 9 9 4 369 367 24 24 24 24 24 24 29 9 9 4 5 5 5 5 5 5 5 5 5 5 5 5 5 5 5 5 5 5 5 5 5 5 5 5 5 5 5 5 5 5 5 5 5 5 5 5 5 5 5 5 5 5 5 5 5 5 5 5 5 5 5 5 5 5 5 5 5 5 5 5 5 5 5 5 5 5 5 5 5 5 5 5 5 5 5 
5 5 5 5 5 5 5 5 5 9 9 9 9 28 24 24 24 24 24 24 33 32 9 9 9 5 5 5 5 5 5 5 5 5 5 5 5 5 5 5 5 5 5 5 5 5 5 5 5 5 5 5 5 5 5 5 5 5 5 5 5 5 5 5 5 5 5 5 5 5 5 5 5 5 5 5 5 5 5 5 5 5 5 5 5 5 5 5 5 5 5 5 5 5 5 5 5 5 5 5 
5 5 5 5 5 5 5 5 5 9 9 9 9 30 34 24 24 24 33 31 32 9 9 9 5 5 5 5 5 5 5 5 5 5 5 5 5 5 5 5 5 5 5 5 5 5 5 5 5 5 5 5 5 5 5 5 5 5 5 5 5 5 5 5 5 5 5 5 5 5 5 5 5 5 5 5 5 5 5 5 5 5 5 5 5 5 5 5 5 5 5 5 5 5 5 5 5 5 5 5 
5 5 5 5 5 5 5 5 9 9 9 9 9 9 30 34 24 24 29 9 9 9 9 9 5 5 5 5 5 5 5 5 5 5 5 5 5 5 5 5 5 5 5 5 5 5 5 5 5 5 5 5 5 5 5 5 5 5 5 5 5 5 5 5 5 5 5 5 5 5 5 5 5 5 5 5 250 250 251 251 251 251 251 251 251 250 251 250 251 250 251 250 250 250 250 250 251 250 251 251 
5 5 5 5 5 5 5 5 9 9 9 9 9 9 9 28 24 33 32 9 9 9 9 5 5 5 5 5 5 5 5 5 5 5 5 5 5 5 5 5 5 5 5 5 5 5 5 5 5 5 5 5 5 5 5 5 5 5 5 5 5 5 5 5 5 5 5 5 5 5 5 5 5 5 5 5 250 250 251 251 251 251 251 251 251 250 251 250 251 250 251 250 250 250 250 250 251 250 251 251 
5 5 5 5 5 5 5 5 9 9 9 9 9 9 9 30 31 32 9 9 9 9 5 5 5 5 5 5 5 5 5 5 5 5 5 5 5 5 5 5 5 5 5 5 5 5 5 5 5 5 5 5 5 5 5 5 5 5 5 5 5 5 5 5 5 5 5 5 5 5 5 5 5 5 5 5 250 250 251 251 251 251 251 251 251 250 251 250 251 250 251 250 250 250 250 250 251 250 251 251 
5 5 5 5 5 5 5 5 9 9 49 50 50 51 9 9 9 9 9 9 9 5 5 5 5 5 5 5 5 5 5 5 5 5 5 5 5 5 5 5 5 5 5 5 5 5 5 5 5 5 5 5 5 5 5 5 5 5 5 5 5 5 5 5 5 5 5 5 5 5 5 5 5 5 5 5 250 250 251 251 251 251 251 251 251 250 251 250 251 250 251 250 250 250 250 250 251 250 251 251 
5 5 5 5 5 5 5 5 5 9 52 53 54 55 9 8 8 8 9 9 5 5 5 5 5 5 5 5 5 5 5 5 5 5 5 5 5 5 5 5 5 5 5 5 5 5 5 5 5 5 5 5 5 5 5 5 5 5 5 5 5 5 5 5 5 5 5 5 5 5 5 5 5 5 5 5 250 250 251 251 251 251 251 251 251 250 251 250 251 250 251 250 250 250 250 250 251 250 251 251 
5 5 5 5 5 5 5 5 5 9 56 57 58 59 9 8 8 8 9 9 9 9 5 5 5 5 5 5 5 5 5 5 5 5 5 5 5 5 5 5 5 5 5 5 5 5 5 5 5 5 5 5 5 5 5 5 5 5 5 5 5 5 5 5 5 5 5 5 5 5 5 5 5 5 5 5 250 250 251 251 251 251 251 251 251 250 251 250 251 250 251 250 250 250 250 250 251 250 251 251 
5 5 5 5 5 5 5 5 5 9 14 6 13 9 9 8 8 8 9 9 9 9 9 9 9 5 5 5 5 5 5 5 5 5 5 5 5 5 5 5 5 5 5 5 5 5 5 5 5 5 5 5 5 5 5 5 5 5 5 5 5 5 5 5 5 5 5 5 5 5 5 5 5 5 5 5 250 250 251 251 251 251 251 251 251 250 251 250 251 250 251 250 250 250 250 250 251 250 251 251 
5 5 5 5 5 5 5 5 5 9 8 8 8 8 8 8 8 8 9 62 63 64 65 66 9 9 9 9 9 9 9 9 5 5 5 5 5 5 5 5 5 5 5 5 5 5 5 5 5 5 5 5 5 5 5 5 5 5 5 5 5 5 5 5 5 5 5 5 5 5 5 5 5 5 5 5 250 250 251 251 251 251 251 251 251 250 251 250 251 250 251 250 250 250 250 250 251 250 251 251 
5 5 5 5 5 5 5 5 5 9 8 8 8 8 8 8 8 8 9 67 68 69 70 71 9 9 9 82 83 84 85 9 9 5 5 5 5 5 5 5 5 5 5 5 5 5 5 5 5 5 5 5 5 5 5 5 5 5 5 5 5 5 5 5 5 5 5 5 5 5 5 5 5 5 5 5 250 250 251 251 251 251 251 251 251 250 251 250 251 250 251 250 250 250 250 250 251 250 251 251 
5 5 5 5 5 5 5 5 9 9 9 9 9 9 9 8 8 8 9 72 73 74 75 76 9 9 9 86 87 88 89 9 9 9 5 5 5 5 5 5 5 5 5 5 5 5 5 5 5 5 5 5 5 5 5 5 5 5 5 5 5 5 5 5 5 5 5 5 5 5 5 5 5 5 5 5 250 250 251 251 251 251 251 251 251 250 251 250 251 250 251 250 250 250 250 250 251 250 251 251 
5 5 5 5 5 5 5 5 9 415 416 416 416 417 9 8 8 8 9 77 78 79 80 81 9 9 9 90 91 92 93 9 9 9 9 5 5 5 5 5 5 5 5 5 5 5 5 5 5 5 5 5 5 5 5 5 5 5 5 5 5 5 5 5 5 5 5 5 5 5 5 5 5 5 5 5 250 250 251 251 251 251 251 251 251 250 251 250 251 250 251 250 250 250 250 250 251 250 251 251 
5 5 5 5 5 5 5 5 9 418 419 419 419 420 9 8 8 8 9 9 8 8 8 9 9 9 9 9 8 8 9 9 9 9 9 9 9 9 9 9 9 9 5 5 5 5 5 5 5 5 5 5 5 5 5 5 5 5 5 5 5 5 5 5 5 5 5 5 5 5 5 5 5 5 5 5 250 253 258 258 258 259 258 258 261 250 251 250 251 250 251 250 250 250 250 250 251 250 251 251 
5 5 5 5 5 5 5 5 9 421 422 423 423 424 9 8 8 8 8 8 8 8 8 8 8 8 8 8 8 8 8 8 8 8 9 146 147 147 147 147 147 148 9 5 5 5 5 5 5 5 5 5 5 5 5 5 5 5 5 5 5 5 5 5 5 5 5 5 5 5 5 5 5 5 5 5 250 9 9 9 9 9 9 9 250 250 251 250 251 250 251 250 250 250 250 250 251 250 251 251 
5 5 5 5 5 5 5 5 9 425 426 427 428 429 9 8 8 8 8 8 8 8 8 8 8 8 8 8 8 8 8 8 8 8 9 149 150 150 150 150 150 151 9 5 5 5 5 5 5 5 5 5 5 5 5 5 5 5 5 5 5 5 5 5 5 5 5 5 5 5 5 5 5 5 5 5 250 9 7 7 7 7 7 9 250 250 251 250 251 250 251 250 250 250 250 250 251 250 251 251 
5 5 5 5 5 5 5 5 9 14 6 13 9 9 9 8 8 8 8 8 8 8 8 8 8 8 8 8 8 8 8 8 8 8 9 149 150 150 150 150 150 151 9 5 5 5 5 5 5 5 5 5 5 5 5 5 5 5 5 5 5 5 5 5 5 5 5 5 5 5 5 5 5 5 5 5 250 9 7 7 7 7 7 9 250 250 251 250 251 250 251 250 250 250 250 250 251 250 251 251 
5 5 5 5 5 5 5 5 9 14 6 13 49 50 50 51 9 49 50 50 51 9 49 50 50 51 9 49 50 50 51 8 8 8 9 152 153 154 155 156 156 157 9 5 5 5 5 5 5 5 5 5 5 5 5 5 5 5 5 5 5 5 5 5 5 5 5 5 5 5 5 5 5 5 5 5 250 9 7 7 7 7 7 9 250 250 251 250 251 250 251 250 250 250 250 250 251 250 251 251 
5 5 5 5 5 5 5 5 9 14 6 13 52 53 54 55 9 52 53 54 55 9 52 53 54 55 9 52 53 54 55 8 8 8 9 158 159 160 161 162 163 164 9 9 5 209 210 211 212 5 5 5 5 5 5 5 5 5 5 5 5 5 5 5 5 5 5 5 5 5 5 5 5 5 5 5 250 9 7 7 7 7 7 9 250 250 251 250 251 250 251 250 250 250 250 250 251 250 251 251 
5 5 5 5 5 5 5 5 9 14 6 13 56 57 58 59 9 56 57 58 59 9 56 57 58 59 9 56 57 58 59 8 8 8 9 9 8 8 8 9 9 9 9 9 9 213 214 215 216 5 5 5 5 5 5 5 5 5 5 5 5 5 5 5 5 5 5 5 5 5 5 5 5 5 5 5 250 9 7 7 7 7 7 9 250 250 251 250 251 250 251 250 250 250 250 250 251 263 261 251 
5 5 5 5 5 5 5 5 9 8 8 8 8 8 8 8 8 8 8 8 8 8 8 8 8 8 8 8 8 8 8 8 8 8 8 8 8 8 8 8 9 9 9 9 140 217 218 219 220 141 5 5 5 5 5 5 5 5 5 5 5 5 5 5 5 5 5 5 5 5 5 5 5 5 5 5 250 9 7 7 7 7 7 9 250 250 251 250 251 250 251 250 250 250 250 263 261 251 263 261 
5 5 5 5 5 5 5 5 9 8 8 8 8 8 8 8 8 8 8 8 8 8 8 8 8 8 8 8 8 8 8 8 8 8 8 8 8 8 8 8 9 9 9 5 143 229 230 231 224 144 5 5 5 5 5 5 5 5 5 5 5 5 5 5 5 5 5 5 5 5 5 5 5 5 5 5 250 9 7 7 7 7 7 9 250 250 251 250 251 263 261 250 250 250 263 261 263 261 251 263 
5 5 5 5 5 5 5 5 5 5 5 5 5 5 5 5 5 5 5 9 140 139 139 141 9 446 447 447 447 448 9 8 8 8 9 9 9 9 9 9 9 9 5 9 143 229 230 231 224 144 5 5 5 5 5 5 5 5 5 5 5 5 5 5 5 5 5 5 5 5 5 5 5 5 5 5 250 9 7 7 7 7 7 9 250 250 251 263 261 251 250 250 250 263 261 263 261 263 261 251 
5 5 5 5 5 5 5 5 5 5 5 5 5 5 5 209 210 211 212 9 143 5 9 144 9 449 450 450 450 451 5 8 8 8 9 49 50 50 51 9 9 5 9 5 143 229 230 231 224 144 5 5 5 5 5 5 5 5 5 5 5 5 5 5 5 5 5 5 5 5 5 5 5 5 5 5 250 9 9 9 9 9 9 9 250 263 261 251 250 251 250 250 263 261 250 251 263 261 263 261 
5 5 5 5 5 5 5 5 5 5 5 5 5 5 5 213 214 215 216 9 143 1 5 144 9 452 453 454 455 456 9 8 8 8 9 52 53 54 55 9 9 5 5 9 143 232 233 234 228 144 5 5 5 5 5 5 5 5 5 5 5 5 5 5 5 5 5 5 5 5 5 5 5 5 5 5 253 258 258 254 255 258 258 261 263 261 250 251 250 251 250 263 261 250 250 251 251 250 251 250 
5 5 5 5 5 5 5 5 5 5 5 5 5 5 5 217 218 219 220 9 142 139 139 145 9 457 458 183 459 460 9 8 8 8 9 56 57 58 59 9 9 9 5 9 142 139 139 139 139 145 5 5 5 5 5 5 5 5 5 5 5 5 5 5 5 5 9 5 5 5 5 5 5 5 5 5 9 249 9 9 9 9 9 253 261 250 250 251 263 261 263 261 250 250 263 258 261 263 258 261 
5 5 5 5 5 5 5 5 5 5 5 5 5 5 5 229 230 231 224 9 9 9 9 9 9 5 8 8 8 9 9 8 8 8 9 14 6 13 9 9 9 9 9 9 9 9 9 5 5 5 5 5 5 5 5 5 5 5 5 5 5 5 249 9 9 5 9 9 5 5 5 5 5 5 5 5 9 9 249 9 9 7 7 9 250 250 263 258 261 263 261 250 250 263 258 261 263 258 261 250 
5 5 5 5 5 5 5 5 5 5 5 5 5 5 5 229 230 231 224 9 5 9 8 8 8 8 8 8 8 8 8 8 8 8 8 8 8 8 8 8 8 8 9 9 9 9 5 5 5 5 5 5 5 5 5 5 5 5 5 5 5 5 9 9 9 5 5 9 249 9 9 5 5 5 5 5 9 9 9 9 9 9 7 9 250 263 258 259 261 251 250 250 263 258 261 263 258 261 250 250 
5 5 5 5 5 5 5 5 5 5 5 5 5 5 5 221 222 223 224 9 5 5 8 8 8 8 8 8 8 8 8 8 8 8 8 8 8 8 8 8 8 8 9 9 9 5 5 5 5 5 5 9 9 5 5 5 301 302 302 302 303 9 9 9 9 4 5 9 9 9 9 9 5 5 5 5 9 7 7 7 7 9 9 9 253 261 4 9 250 251 250 263 258 261 263 258 261 250 250 250 
5 5 5 5 5 5 5 5 5 5 5 5 5 5 5 225 226 227 228 5 9 9 8 8 8 8 8 8 8 8 8 8 8 8 8 8 8 8 8 8 8 8 9 9 9 5 5 5 9 9 9 9 9 9 5 301 312 309 307 310 311 302 303 9 9 9 47 9 9 9 9 9 5 9 9 249 9 7 7 7 7 9 9 9 9 253 261 1 253 261 263 258 261 263 258 261 250 250 250 250 
5 5 5 5 5 5 5 5 5 5 5 5 5 5 5 8 8 8 8 8 8 8 8 8 8 9 9 9 9 5 5 8 8 8 9 9 9 9 9 9 9 9 9 9 5 5 5 9 9 9 9 9 9 9 9 6 6 6 9 306 310 300 311 303 9 9 46 9 9 9 9 9 47 9 9 9 9 7 7 7 7 9 249 9 9 9 253 254 261 263 258 261 263 258 261 250 250 250 250 250 
5 5 5 5 5 5 5 5 5 5 5 5 5 5 5 8 8 8 8 8 8 8 8 8 8 9 5 9 5 9 5 8 8 8 9 394 395 395 395 396 9 9 5 5 5 5 9 9 9 9 9 9 9 9 9 304 300 305 9 9 306 307 310 305 9 9 48 9 9 9 9 9 46 9 249 9 9 9 9 9 9 9 9 9 249 9 9 9 253 258 261 263 258 261 250 250 250 250 250 250 
5 5 5 5 5 5 5 5 5 5 5 5 5 5 5 8 8 8 8 8 8 8 8 8 8 9 9 5 9 9 9 8 8 8 9 397 398 398 398 399 9 9 5 5 5 9 9 9 9 9 9 9 9 9 9 306 310 311 303 9 9 9 6 6 9 9 5 9 9 9 9 9 48 9 9 9 249 249 249 9 9 9 9 9 9 9 9 9 249 249 253 259 261 250 250 250 250 250 250 250 
5 5 5 5 5 5 5 5 5 5 5 5 5 5 5 5 5 5 5 5 9 9 9 9 9 9 5 9 9 9 9 8 8 8 9 400 401 402 403 404 9 9 5 5 5 9 9 9 9 9 9 9 9 9 5 5 306 310 305 9 9 9 304 305 5 5 9 9 9 249 9 9 5 249 249 249 9 9 9 249 249 9 9 249 249 249 249 249 249 9 9 9 250 250 250 250 250 250 250 250 
5 5 5 5 5 5 5 5 5 5 5 5 5 5 5 5 5 5 5 5 9 9 165 166 166 166 166 167 9 5 9 8 8 8 9 405 406 407 408 409 9 9 9 5 5 5 9 9 9 9 9 9 5 5 5 5 9 304 311 303 9 249 304 305 9 9 9 301 302 303 9 9 9 249 9 9 249 9 9 9 249 249 249 9 9 9 9 249 9 9 9 9 250 250 250 250 250 250 250 250 
5 5 5 5 5 5 5 5 5 5 5 5 5 5 5 5 5 5 5 5 9 9 168 169 169 169 169 170 5 9 9 8 8 8 9 9 8 410 411 412 9 9 9 5 5 5 5 5 9 9 9 9 5 5 9 9 9 304 309 308 9 301 312 305 9 301 302 312 300 311 6 302 303 9 9 9 9 9 9 9 9 9 9 9 9 9 9 9 4 9 9 9 250 250 250 250 250 250 250 250 
5 5 5 5 5 5 5 5 5 5 5 5 5 5 5 5 5 5 5 5 5 9 171 172 172 172 172 173 9 5 9 8 8 8 9 9 8 9 9 9 9 9 9 9 5 5 5 5 41 40 40 42 5 9 9 9 9 6 6 9 9 304 300 311 302 312 300 300 309 307 6 310 305 9 9 9 9 9 249 9 9 249 249 249 249 41 40 42 249 9 9 4 250 250 250 250 250 250 250 263 
5 5 5 5 5 5 5 5 5 5 5 5 5 5 5 5 5 5 5 5 5 9 174 175 176 177 178 179 9 9 5 8 8 8 8 8 8 8 8 8 8 8 8 8 8 8 8 8 9 9 9 9 5 9 9 9 301 300 311 303 9 304 300 300 300 300 300 309 308 9 9 304 311 303 9 9 9 9 249 249 249 249 9 9 9 9 9 9 9 9 9 249 250 250 250 250 250 250 263 261 
5 5 5 5 5 5 5 5 5 5 5 5 5 5 5 5 5 5 5 5 5 9 180 181 182 183 184 185 9 9 5 8 8 8 8 8 8 8 8 8 8 8 8 8 8 8 8 8 9 9 9 9 5 9 9 9 304 300 300 311 6 312 300 300 300 300 300 305 249 9 9 306 310 311 303 249 249 9 9 9 249 249 9 9 9 9 9 9 9 9 9 249 250 250 250 250 250 263 261 263 
5 5 5 5 5 5 5 5 5 5 5 5 5 5 5 5 5 5 5 5 5 5 9 9 14 6 13 9 9 5 5 8 8 8 8 8 8 8 8 8 8 8 8 8 8 8 8 8 9 9 9 9 5 9 9 5 304 300 300 309 6 310 300 300 300 300 309 308 9 9 249 9 304 300 305 9 9 9 9 9 249 9 9 9 9 9 9 9 9 9 9 9 250 250 250 250 263 261 263 261 
5 5 5 5 5 5 5 5 5 5 5 5 5 5 5 5 5 5 5 5 5 5 9 9 8 8 8 8 8 8 8 8 8 8 9 9 9 9 5 5 5 5 5 5 5 5 5 5 41 40 40 42 5 9 9 301 312 300 309 308 9 304 300 300 300 309 308 249 9 9 9 9 6 6 6 9 9 9 9 9 249 9 9 9 4 9 9 9 9 9 9 249 250 250 250 263 261 263 261 263 
5 5 5 5 5 5 5 5 5 5 5 5 5 5 5 5 5 5 5 5 5 5 9 9 8 8 8 8 8 8 8 8 8 8 9 9 9 5 5 5 5 5 5 5 5 5 5 5 9 9 9 9 5 301 302 312 300 300 305 9 9 306 310 300 309 308 9 9 9 4 301 302 312 300 311 302 303 9 9 5 9 9 5 249 5 5 5 9 9 249 9 9 250 250 263 261 263 261 263 258 
5 5 5 5 5 5 5 5 5 5 5 5 5 5 5 5 5 5 5 5 5 5 5 9 8 8 8 8 8 8 8 8 8 8 9 9 5 5 5 5 5 5 5 5 5 5 5 5 9 9 9 9 9 304 300 300 309 307 308 9 9 9 304 309 308 9 9 9 9 249 304 300 300 300 300 300 311 303 5 5 9 9 9 5 5 249 5 5 5 9 9 9 250 263 261 263 261 263 258 261 
5 5 5 5 5 5 5 5 5 5 5 5 5 5 5 5 5 5 5 5 5 5 5 9 9 9 9 9 9 9 9 8 8 8 9 5 5 5 5 5 5 5 5 5 5 5 5 5 9 9 9 9 9 304 300 309 308 9 9 249 9 9 6 6 9 9 9 9 9 301 312 300 300 300 300 300 300 311 303 9 5 9 9 9 9 5 5 249 5 249 9 9 253 261 263 261 263 258 261 263 
5 5 5 5 5 5 5 5 5 5 5 5 5 5 5 5 5 5 5 5 5 5 5 5 5 5 9 9 9 9 9 8 8 8 5 5 5 5 5 5 5 5 5 5 5 5 5 5 9 9 9 9 301 312 309 308 9 9 9 9 9 9 304 305 9 249 301 302 6 312 300 300 300 300 300 300 300 300 311 302 302 303 9 9 9 9 9 9 9 9 249 249 5 253 261 263 258 261 263 258 
5 5 5 5 5 5 5 5 5 5 5 5 5 5 5 5 5 5 5 5 5 5 5 5 5 5 5 9 9 9 9 8 8 8 5 5 5 5 5 5 5 5 5 5 5 5 5 5 5 9 9 9 6 6 6 9 9 249 9 9 9 9 304 311 302 302 312 300 6 307 310 300 300 300 300 300 300 300 300 300 300 311 302 6 302 303 9 9 9 9 9 9 5 5 253 258 261 263 258 261 
5 5 5 5 5 5 5 5 5 5 5 5 5 5 5 5 5 5 5 5 5 5 5 5 5 5 5 5 5 5 9 8 8 8 5 5 5 5 5 5 5 5 5 5 5 5 5 5 5 5 5 5 304 300 305 9 9 9 9 9 249 301 312 300 300 300 300 305 9 9 304 300 300 300 300 300 300 300 300 300 300 309 307 6 310 311 302 303 9 9 9 5 5 5 5 5 253 258 261 263 
5 5 5 5 5 5 5 5 5 5 5 5 5 5 5 5 5 5 5 5 5 5 5 5 5 5 5 5 5 5 5 8 8 8 5 5 5 5 5 5 5 5 5 5 5 5 5 5 5 5 5 5 304 300 311 303 249 9 9 9 301 312 300 300 300 300 300 305 9 9 306 310 300 300 300 300 300 300 300 300 300 305 9 9 306 310 300 311 303 9 9 5 5 5 5 5 5 5 253 261 
5 5 5 5 5 5 5 5 5 5 5 5 5 5 5 5 5 5 5 5 5 5 5 5 5 5 5 5 5 5 117 118 118 118 119 5 5 5 5 5 5 5 5 5 5 5 5 5 5 5 5 5 306 310 300 311 303 9 249 301 312 300 300 300 300 300 300 305 9 9 249 306 310 300 300 300 300 300 300 300 309 308 9 9 9 304 300 300 311 303 9 5 5 5 5 5 5 5 5 253 
5 5 5 5 5 5 5 5 5 5 5 5 5 5 5 5 5 5 5 5 5 5 5 5 5 5 5 5 5 5 120 121 121 121 122 5 5 5 5 5 5 5 5 5 5 5 5 5 5 5 5 5 5 306 310 300 311 302 302 312 300 300 300 300 300 300 300 311 303 9 9 9 306 310 300 300 300 300 300 309 308 9 9 9 9 304 300 300 300 311 303 5 5 5 5 5 5 5 5 5 
5 5 5 5 5 5 5 5 5 5 5 5 5 5 5 5 5 5 5 5 5 5 5 5 5 5 5 5 5 5 123 124 124 124 125 5 5 5 5 5 5 5 5 5 5 5 5 5 5 5 5 5 5 5 304 300 300 300 300 300 300 300 300 300 300 300 300 300 311 303 9 9 9 306 307 307 310 300 309 308 9 9 9 249 301 312 300 300 300 300 305 5 5 5 5 5 5 5 5 5 
5 5 5 5 5 5 5 5 5 5 5 5 5 5 5 5 5 5 5 5 5 5 5 5 5 5 5 5 5 5 126 127 128 129 130 5 5 5 5 5 5 5 5 5 5 5 5 5 5 5 5 5 5 5 306 310 300 300 300 300 300 300 300 300 300 300 300 300 300 311 303 249 9 9 9 9 306 307 308 249 9 9 301 302 312 300 300 300 300 300 305 5 5 5 5 5 5 5 5 5 
5 5 5 5 5 5 5 5 5 5 5 5 5 5 5 5 5 5 5 5 5 5 5 5 5 5 5 5 5 5 131 132 133 134 135 5 5 5 5 5 5 5 5 5 5 5 5 5 5 5 5 5 5 5 5 304 300 300 300 300 300 300 300 300 300 300 300 300 300 300 311 303 9 9 9 9 9 9 9 9 9 301 312 300 300 300 300 300 300 300 305 5 5 5 5 5 5 5 5 5 
5 5 5 5 5 5 5 5 5 5 5 5 5 5 5 5 5 5 5 5 5 5 5 5 5 5 5 5 5 5 5 136 137 138 5 5 5 5 5 5 5 5 5 5 5 5 5 5 5 5 5 5 5 5 5 304 300 300 300 300 300 300 300 300 300 300 300 300 300 300 300 311 303 9 249 9 9 9 9 249 9 304 300 300 300 300 300 300 300 300 311 303 5 5 5 5 5 5 5 5 
5 5 5 5 5 5 5 5 5 5 5 5 5 5 5 5 5 5 5 5 5 5 5 5 5 5 5 5 5 5 5 5 5 5 5 5 5 5 5 5 5 5 5 5 5 5 5 5 5 5 5 5 5 5 5 306 310 300 300 300 300 300 300 300 300 300 300 300 300 300 300 300 311 302 302 302 302 302 302 302 302 312 300 300 300 300 300 300 300 300 300 305 5 5 5 5 5 5 5 5 
5 5 5 5 5 5 5 5 5 5 5 5 5 5 5 5 5 5 5 5 5 5 5 5 5 5 5 5 5 5 5 5 5 5 5 5 5 5 5 5 5 5 5 5 5 5 5 5 5 5 5 5 5 5 5 5 304 300 300 300 300 300 300 300 300 300 300 300 300 300 300 300 300 300 300 300 300 300 300 300 300 300 300 300 300 300 300 300 300 300 300 311 303 5 5 5 5 5 5 5 
