5 5 5 5 5 5 5 5 5 5 5 5 5 5 5 5 5 5 5 5 5 5 5 5 5 5 5 5 5 5 5 5 5 5 5 5 5 5 5 5 5 9 9 9 9 9 9 9 9 9 1 9 9 9 9 1 9 30 34 3 24 35 27 5 5 5 5 5 5 5 5 5 5 5 5 5 5 5 5 5 5 5 5 5 5 5 5 5 5 5 5 5 5 5 5 5 5 5 5 5 
5 5 5 5 5 5 5 5 5 5 5 5 5 5 5 5 5 5 5 5 5 5 5 5 5 5 5 5 5 5 5 5 5 5 5 5 5 5 5 5 5 5 9 9 9 9 9 18 16 19 9 9 9 9 5 5 5 5 30 34 24 24 35 27 5 5 5 5 5 5 5 5 5 5 5 5 5 5 5 5 5 5 5 5 5 5 5 5 5 5 5 5 5 5 5 5 5 5 5 5 
5 5 5 5 5 5 5 5 5 5 5 5 5 5 5 5 5 5 5 5 5 5 5 5 5 5 5 5 5 5 5 5 5 5 5 5 5 5 5 5 5 5 9 9 9 9 9 114 115 116 9 9 1 5 5 5 5 5 5 28 3 24 24 35 27 5 5 5 5 5 5 5 5 5 5 5 5 5 5 5 5 5 5 5 5 5 5 5 5 5 5 5 5 5 5 5 5 5 5 5 
5 5 5 5 5 5 5 5 5 5 5 5 5 5 5 5 5 5 5 5 5 5 5 5 5 5 5 5 5 5 5 5 5 5 5 5 5 5 5 5 5 5 5 9 9 9 186 117 118 119 188 5 5 5 5 5 5 5 5 28 24 24 3 24 29 5 5 5 5 5 5 5 5 5 5 5 5 5 5 5 5 5 5 5 5 5 5 5 5 5 5 5 5 5 5 5 5 5 5 5 
5 5 5 5 5 5 5 5 5 5 5 5 5 5 5 5 5 5 5 5 5 5 5 5 5 5 5 5 5 5 5 5 5 5 5 5 5 5 5 5 5 5 5 5 5 5 190 191 191 191 192 5 5 5 5 5 5 5 5 28 24 24 367 367 370 5 5 5 5 5 5 5 5 5 5 5 5 5 5 5 5 5 5 5 5 5 5 5 5 5 9 5 5 5 5 5 5 5 5 5 
5 5 5 5 5 5 5 5 5 5 5 5 5 5 5 5 5 5 5 5 5 5 5 5 5 5 5 5 5 5 5 5 5 5 5 5 5 5 5 5 5 5 5 5 5 5 195 196 196 196 197 5 5 5 5 5 5 5 5 369 367 367 24 24 29 9 1 9 5 5 5 5 5 5 5 5 5 5 5 5 5 5 5 5 5 5 5 9 9 1 9 9 5 5 5 5 5 5 5 5 
5 5 5 5 5 5 5 5 5 5 5 5 5 5 5 5 5 5 5 5 5 5 5 5 5 5 5 5 5 5 5 5 5 5 5 5 5 5 5 5 5 5 5 5 5 5 126 127 128 129 130 5 5 5 5 5 5 5 25 36 24 24 24 3 35 27 9 9 9 1 9 9 5 5 5 5 5 5 5 5 5 5 5 5 5 5 9 1 9 9 9 1 9 5 5 5 5 5 5 5 
5 5 5 5 5 5 5 5 5 5 5 5 5 5 5 5 5 5 5 5 5 5 5 5 5 5 5 5 5 5 5 5 5 5 5 5 5 5 5 5 5 5 5 5 5 5 131 132 133 134 135 5 5 5 5 5 5 25 36 24 24 24 24 24 24 35 26 26 26 26 26 26 26 26 26 26 26 26 26 26 26 26 26 26 26 26 26 26 26 26 26 26 27 5 5 5 5 5 5 5 
5 5 5 5 5 5 5 5 5 5 5 9 9 9 5 5 5 5 5 5 25 26 26 26 26 26 26 26 26 26 26 26 26 26 26 26 26 26 26 26 26 27 5 5 9 9 9 136 137 138 9 9 5 5 5 25 26 36 24 24 3 24 24 24 24 24 3 24 24 24 24 24 24 24 24 24 3 24 24 24 3 24 24 24 24 24 24 3 24 24 24 24 35 27 5 5 5 5 5 5 
5 5 5 5 5 5 5 5 5 5 9 9 1 9 9 5 25 26 26 26 36 24 24 24 24 24 24 24 24 24 24 24 24 24 24 24 24 24 24 24 24 35 26 27 9 9 9 14 6 13 9 1 9 25 26 36 24 24 24 24 24 367 24 24 24 24 24 24 24 24 24 24 24 24 24 24 24 367 24 24 24 24 33 31 31 31 31 31 31 34 24 24 24 35 27 5 5 5 5 5 
5 5 5 5 5 5 5 5 5 9 9 9 9 25 26 368 36 24 24 24 24 24 24 24 24 24 24 24 3 24 24 24 24 24 3 24 24 367 24 24 24 24 24 35 26 27 1 20 11 21 9 25 26 36 24 24 24 24 24 24 24 24 24 24 24 24 24 24 3 24 367 24 24 3 24 367 24 24 24 367 24 33 32 9 9 1 9 9 9 30 31 34 24 24 29 5 5 5 5 5 
5 5 5 5 5 5 5 5 9 1 9 9 25 36 24 367 24 24 24 24 24 24 24 24 24 24 24 24 24 24 24 24 24 24 24 367 24 24 24 3 24 24 24 24 24 35 26 26 26 26 26 36 24 24 24 3 24 24 24 24 24 24 24 3 24 24 24 24 24 24 24 24 24 24 24 24 367 367 24 24 24 29 9 9 9 9 9 9 9 9 1 30 34 24 29 5 5 5 5 5 
5 5 5 5 5 5 5 1 9 9 9 25 36 24 367 24 24 3 24 24 24 24 24 3 24 367 24 24 24 24 24 24 24 24 24 24 24 367 24 24 24 24 24 24 24 24 24 24 3 24 24 24 24 24 24 24 24 24 24 24 24 24 24 24 24 24 24 24 24 24 24 24 24 24 24 24 24 24 24 24 24 29 1 25 26 27 9 1 9 9 9 9 28 24 29 5 5 5 5 5 
5 5 5 5 5 5 5 9 9 9 25 36 24 24 24 367 24 24 24 24 24 24 24 24 24 24 367 3 367 24 24 24 24 24 24 367 367 24 24 24 24 24 24 24 367 24 24 24 24 24 24 24 367 3 24 24 24 24 24 24 3 24 24 24 367 24 24 24 24 24 24 24 3 24 24 24 24 24 24 24 24 35 26 36 33 32 9 9 9 9 9 25 36 24 29 5 5 5 5 5 
5 5 5 5 5 5 5 9 1 9 28 24 24 24 24 24 367 24 24 24 24 24 24 367 24 367 367 24 24 24 24 3 24 24 24 24 24 24 24 24 24 24 24 367 24 24 24 24 24 24 24 367 367 367 24 24 24 24 24 24 24 24 24 367 367 367 3 24 24 24 24 24 24 24 24 24 24 24 3 24 24 24 24 33 32 9 9 9 9 1 25 36 24 24 29 5 5 5 5 5 
5 5 5 5 5 5 5 5 9 25 36 24 3 24 24 24 24 367 24 24 3 24 24 24 24 367 24 367 24 24 24 24 24 24 24 3 24 24 24 24 24 24 24 24 24 24 24 24 24 24 24 367 367 24 24 24 24 24 24 24 3 24 24 24 367 24 24 24 24 24 24 24 24 24 24 24 24 367 24 24 367 24 3 29 9 9 9 9 25 26 36 24 24 24 29 5 5 5 5 5 
5 5 5 5 5 5 5 5 5 28 24 24 24 24 24 24 367 3 24 24 24 24 24 3 24 367 3 24 24 24 24 24 24 24 24 24 24 24 24 24 24 24 24 24 24 24 24 24 3 24 24 24 3 24 24 24 24 24 24 24 24 24 24 367 3 24 24 24 3 24 24 24 24 24 24 24 24 24 367 367 367 24 24 29 9 1 25 26 36 24 24 24 24 24 29 5 5 5 5 5 
5 5 5 5 5 5 5 5 5 28 24 24 24 24 24 24 367 24 24 24 24 24 24 24 24 24 24 24 24 24 24 24 24 24 24 24 24 24 24 3 24 24 24 24 367 367 24 24 24 24 24 24 24 24 24 24 24 24 24 24 24 24 24 24 24 24 24 24 24 24 24 24 24 24 3 24 24 24 367 367 24 367 24 35 26 26 36 367 367 24 24 24 24 3 29 5 5 5 5 5 
5 5 5 5 5 5 5 5 5 28 24 24 24 24 24 24 24 367 33 31 31 31 34 24 24 24 24 24 24 24 24 3 3 24 24 24 24 24 24 24 24 24 24 367 367 24 24 24 24 24 24 24 367 367 24 24 3 24 24 24 24 24 24 24 24 24 24 24 24 24 24 24 367 24 24 24 24 24 24 24 3 24 24 24 24 24 24 24 24 367 24 24 24 24 29 5 5 5 5 5 
5 5 5 5 5 5 5 5 5 28 24 24 24 24 24 24 33 371 32 9 9 1 30 34 24 24 24 3 24 24 24 24 24 24 24 24 24 24 24 24 24 24 24 24 24 24 3 24 24 24 24 24 367 24 24 24 24 24 24 3 24 24 24 24 24 24 24 24 24 3 24 24 24 24 24 3 24 24 24 24 24 24 24 24 24 3 24 24 24 24 3 24 24 24 29 5 5 5 5 5 
5 5 5 5 5 5 5 5 5 28 24 24 24 3 33 31 32 9 9 9 9 9 9 30 31 31 34 24 24 24 24 24 24 24 24 3 24 24 24 24 24 3 24 24 24 24 24 24 24 24 24 24 24 24 24 24 24 24 24 24 24 24 24 24 24 24 24 24 24 24 24 24 24 24 24 24 24 24 24 24 24 24 24 24 24 24 24 24 24 24 24 24 24 24 29 5 5 5 5 5 
5 5 5 5 5 5 5 5 5 28 24 24 24 33 32 9 9 9 1 9 9 9 9 9 1 9 28 24 24 24 24 24 24 24 367 24 24 24 24 24 24 24 24 24 367 24 24 24 24 24 24 24 24 24 24 24 24 24 24 24 24 24 367 24 24 24 24 24 24 24 24 24 24 24 24 24 24 24 367 24 24 24 24 24 24 24 24 24 24 24 24 24 24 24 29 5 5 5 5 5 
5 5 5 5 5 5 5 5 5 28 24 24 24 29 9 1 9 9 9 9 9 1 9 9 9 9 28 24 24 24 24 24 24 24 24 24 24 24 3 24 24 24 24 367 24 24 24 24 24 24 24 24 24 24 367 24 24 24 24 24 24 24 24 24 24 3 24 24 24 24 3 24 24 24 24 24 24 24 24 24 24 24 24 3 24 24 24 24 24 24 24 24 24 24 29 5 5 5 5 5 
5 5 5 5 5 5 5 5 5 28 24 3 24 29 9 9 9 9 9 9 9 9 9 9 9 1 28 3 24 24 24 24 24 24 24 24 24 24 24 24 24 24 24 24 367 367 24 24 24 24 24 24 24 367 367 24 24 24 3 24 24 24 24 24 24 24 24 24 24 24 24 24 24 24 24 24 24 24 24 3 24 24 24 24 367 24 24 3 24 24 24 24 24 24 29 5 5 5 5 5 
5 5 5 5 5 5 5 5 9 28 24 24 24 35 26 26 27 9 9 9 1 9 9 9 9 9 28 24 24 24 24 24 367 24 24 24 24 24 24 24 24 24 24 24 367 24 3 24 24 24 24 24 367 24 24 24 24 24 24 24 24 24 24 24 24 24 24 24 24 367 24 24 24 24 24 24 24 24 24 24 24 24 24 367 24 367 24 24 24 24 24 3 24 33 32 5 5 5 5 5 
5 5 5 5 5 5 5 5 9 28 24 24 24 24 24 24 35 368 27 9 9 9 1 9 25 26 36 24 24 24 24 24 24 24 24 24 24 3 24 24 24 24 24 24 24 24 24 24 24 24 24 24 24 24 24 24 24 24 24 24 24 24 24 24 24 3 24 24 367 367 24 24 24 24 3 24 24 24 24 24 24 3 24 24 367 24 24 24 24 24 24 24 24 29 5 5 5 5 5 5 
5 5 5 5 5 5 5 5 1 28 24 24 24 24 24 24 367 367 35 26 26 26 26 26 36 24 367 24 24 24 24 24 24 24 24 24 24 24 24 24 24 24 3 24 24 24 24 24 24 24 24 24 3 24 24 24 24 24 24 24 24 24 24 24 24 24 24 367 24 367 24 24 24 24 24 24 24 24 24 24 33 31 31 31 31 31 31 34 24 24 24 3 24 29 5 5 5 5 5 5 
5 5 5 5 5 5 5 5 25 36 24 24 24 24 24 367 24 24 24 24 24 24 24 24 24 24 24 24 24 24 24 24 3 24 24 24 24 24 24 24 24 24 24 24 24 24 24 24 24 24 24 24 24 367 24 24 24 24 3 24 24 24 24 24 24 24 24 24 24 24 367 24 24 24 24 24 3 24 24 33 32 9 270 257 257 257 271 28 24 24 24 24 33 32 9 5 5 5 5 5 
5 5 5 5 5 5 5 5 28 24 24 24 3 24 24 367 24 24 24 24 24 24 24 24 367 24 24 3 24 24 24 24 24 24 24 24 24 24 24 24 367 24 24 367 367 24 24 24 24 24 24 24 24 367 367 24 24 24 24 24 24 24 24 24 24 24 24 24 24 24 24 24 24 24 24 24 24 24 24 29 9 9 250 251 251 251 252 28 24 24 24 24 29 9 1 5 5 5 5 5 
5 5 5 5 5 5 5 5 369 367 24 24 24 24 367 24 24 24 24 24 24 24 24 24 367 24 367 24 24 24 24 24 24 24 24 24 24 24 24 24 24 24 24 24 367 24 24 24 24 3 24 24 367 24 367 24 24 24 24 24 24 24 24 24 24 3 24 24 24 24 24 24 24 24 24 24 24 24 3 29 9 9 250 251 251 251 252 28 24 3 24 24 29 9 9 5 5 5 5 5 
5 5 5 5 5 5 5 25 36 24 367 367 24 367 24 24 24 24 24 24 24 24 24 24 367 367 24 367 367 24 3 24 24 24 24 367 24 3 24 24 24 24 24 367 24 24 24 24 24 24 24 24 24 367 24 24 24 24 24 24 24 24 24 24 24 24 24 24 24 24 24 24 3 24 24 24 24 3 24 35 27 9 250 251 251 251 252 28 24 24 24 24 29 1 9 5 5 5 5 5 
5 5 5 5 5 5 5 28 24 24 24 24 367 24 3 367 24 24 24 24 3 24 367 24 24 24 367 24 24 24 24 24 24 24 24 24 24 24 24 24 24 24 24 24 24 367 24 24 24 24 24 24 24 24 24 24 24 24 24 24 24 3 24 24 24 24 24 24 24 24 24 24 24 24 24 24 24 24 24 24 29 9 250 251 251 251 252 28 24 24 24 24 35 27 9 5 5 5 5 5 
5 5 5 5 5 25 368 36 24 24 24 24 24 24 24 24 24 24 24 24 24 24 24 24 367 24 24 24 24 24 24 24 3 24 24 24 24 24 24 24 24 24 24 24 24 24 24 24 3 24 24 24 24 24 24 24 24 24 24 24 24 3 24 24 24 24 3 24 24 367 24 24 24 24 24 24 24 24 24 24 29 9 253 259 258 258 256 28 24 24 24 24 24 29 9 5 5 5 5 5 
26 26 26 26 26 36 367 24 24 24 24 24 24 24 24 24 24 24 24 24 24 24 24 24 24 24 24 24 24 24 24 24 24 24 24 24 24 24 24 24 24 24 3 24 24 24 24 24 24 24 24 24 24 367 3 24 24 24 24 24 24 24 24 24 24 24 24 24 24 24 24 24 3 24 24 24 24 24 24 24 29 9 9 9 9 9 9 28 3 24 24 24 24 29 5 5 5 5 5 5 
24 24 24 3 24 367 33 31 34 24 24 24 24 24 24 24 24 24 24 24 24 24 24 24 24 24 24 24 24 24 24 24 24 24 3 24 367 24 24 24 24 24 24 24 367 24 24 24 24 24 24 24 367 24 367 24 24 24 3 24 24 24 24 24 24 24 24 24 24 24 24 24 24 24 24 24 3 24 24 24 35 26 26 26 26 26 26 36 24 24 24 24 24 29 5 5 5 5 5 5 
24 24 24 24 24 367 29 9 28 24 24 24 24 24 24 24 24 24 24 24 3 24 24 24 24 24 24 24 3 24 24 24 24 24 24 24 24 24 24 3 24 24 367 367 24 367 24 24 24 24 24 24 24 367 367 24 24 24 24 24 24 3 24 24 24 24 24 24 3 24 24 24 24 24 24 24 24 24 24 24 3 24 24 24 24 3 24 24 24 24 3 24 24 35 27 5 5 5 5 5 
24 3 24 24 24 367 35 26 36 24 24 24 24 3 24 24 24 24 24 24 24 24 24 24 24 24 24 24 24 24 24 24 24 24 24 24 24 24 24 24 24 24 367 367 24 24 24 3 24 24 24 24 24 24 24 24 24 24 24 24 367 24 24 24 24 24 24 24 33 31 31 31 31 31 31 34 24 24 24 24 24 24 24 24 24 24 24 3 24 24 24 24 24 24 29 5 5 5 5 5 
24 24 24 24 24 24 367 24 24 24 24 24 24 24 24 24 24 24 24 24 24 24 24 367 24 24 24 24 24 24 24 24 24 24 24 3 24 24 24 24 3 24 24 24 24 24 24 24 24 24 24 24 24 24 24 24 24 24 3 24 24 24 24 24 24 33 31 31 32 9 9 9 9 9 9 30 34 24 24 24 24 24 24 24 24 24 24 24 24 24 24 24 24 3 29 5 5 5 5 5 
3 24 24 24 24 24 367 24 24 24 24 24 24 24 24 24 24 24 24 24 24 24 24 24 3 367 367 24 24 24 24 24 3 24 24 24 24 24 24 24 24 24 24 24 24 24 24 24 24 24 24 24 3 3 24 24 367 24 24 24 24 24 3 24 33 32 9 9 9 9 1 9 9 9 9 9 28 24 24 3 24 24 24 3 24 24 24 24 3 24 24 24 24 24 29 5 5 5 5 5 
24 24 24 3 24 24 367 24 24 24 24 3 24 24 24 24 24 24 24 24 24 24 24 367 367 367 24 24 24 367 24 24 24 24 24 24 24 24 24 24 24 24 24 367 24 24 24 24 24 367 24 24 24 24 24 24 24 24 24 24 24 24 24 33 32 9 9 9 9 9 9 9 9 9 9 9 28 24 24 24 24 24 24 24 24 367 24 24 24 24 24 3 24 24 29 5 5 5 5 5 
31 31 31 31 31 371 31 34 24 24 24 24 24 24 24 24 24 24 24 3 24 24 24 367 367 24 367 24 367 24 24 24 24 24 24 3 24 24 24 24 24 24 367 24 24 24 24 24 24 24 24 24 24 24 24 24 24 24 24 24 24 24 24 29 9 9 1 9 9 9 9 9 9 1 9 9 28 3 3 24 24 24 24 24 3 24 24 24 24 24 24 24 24 24 29 5 5 5 5 5 
5 5 5 5 5 5 5 30 34 24 24 24 24 24 24 24 24 24 24 24 24 367 24 367 24 367 367 24 367 24 24 24 24 24 24 24 24 24 24 24 24 24 24 367 24 24 24 24 24 24 24 24 24 24 24 24 24 3 24 24 24 24 24 29 9 9 9 9 9 1 9 9 9 9 9 25 36 24 24 24 24 24 24 24 24 24 24 24 24 24 24 24 24 24 29 5 5 5 5 5 
5 5 5 5 5 5 5 5 28 24 24 24 24 24 367 24 24 24 24 24 24 24 24 367 367 24 367 24 24 367 24 24 24 24 24 24 24 24 24 24 24 24 24 24 24 24 24 3 24 24 24 24 367 24 24 24 24 24 24 24 24 24 24 35 27 9 9 9 9 9 9 9 1 9 25 36 24 24 24 24 24 24 24 24 24 24 24 24 3 24 24 24 24 24 29 5 5 5 5 5 
5 5 5 5 5 5 5 5 28 24 24 24 367 24 24 24 367 24 24 24 24 3 24 367 367 24 367 24 24 24 24 367 3 24 24 24 24 3 24 24 24 24 3 24 24 367 367 24 24 24 24 24 24 24 24 24 24 24 24 24 24 24 24 24 29 9 9 1 9 9 9 9 9 9 28 3 24 24 3 24 367 24 24 24 24 33 31 34 24 24 24 24 24 24 29 5 5 5 5 5 
5 5 5 5 5 5 5 5 28 24 24 24 367 367 3 24 24 24 24 24 24 24 24 24 24 24 24 24 367 24 24 24 24 24 24 24 24 24 24 24 24 24 24 24 367 367 367 24 24 24 24 3 24 24 24 24 24 24 24 24 24 24 24 24 35 27 9 9 9 9 9 25 26 26 36 24 24 24 24 24 24 24 3 24 33 32 9 30 34 24 24 3 24 24 29 5 5 5 5 5 
5 5 5 5 5 5 5 5 30 34 24 24 24 24 367 24 24 24 24 24 24 24 24 24 367 24 24 24 367 3 24 24 24 24 24 24 24 24 24 24 24 24 24 24 24 367 3 24 24 24 24 24 24 24 24 3 24 24 24 24 3 24 24 24 24 35 26 26 26 26 26 36 24 24 24 24 24 24 24 3 24 24 24 33 32 9 1 9 28 24 24 24 24 3 29 5 5 5 5 5 
5 5 5 5 5 5 5 5 5 28 24 24 24 24 24 24 24 24 24 24 24 24 24 24 24 24 367 24 24 24 24 24 24 24 24 24 24 24 24 24 24 24 24 24 24 24 24 24 24 24 24 24 24 24 24 24 24 24 24 24 24 24 24 24 24 24 24 24 24 24 24 24 24 24 24 24 24 24 24 24 24 24 33 32 9 9 9 9 30 34 24 24 24 24 29 5 5 5 5 5 
5 5 5 5 5 5 5 5 5 28 24 24 3 24 24 24 3 24 24 24 24 24 24 24 3 24 367 24 24 24 24 3 24 24 24 24 24 3 24 24 24 24 24 24 24 24 24 24 24 24 24 24 24 24 24 24 24 3 24 24 24 24 24 3 24 24 24 24 3 24 24 24 24 3 24 24 24 3 24 24 24 24 29 9 1 9 9 9 9 30 34 24 24 33 32 5 5 5 5 5 
5 5 5 5 5 5 5 5 5 28 24 24 24 24 24 24 24 24 24 24 24 24 3 24 24 24 3 24 24 24 24 367 24 24 24 3 24 24 24 24 24 24 24 3 24 24 24 3 24 24 24 24 24 3 24 367 24 24 24 3 24 24 24 24 367 24 24 24 24 24 24 3 24 24 24 24 24 24 24 24 24 24 29 9 9 25 27 9 9 9 28 24 24 29 5 5 5 5 5 5 
5 5 5 5 5 5 5 5 5 28 24 24 24 24 24 24 24 24 24 24 24 24 24 24 24 24 24 24 24 24 24 24 24 24 24 24 367 24 24 3 24 24 24 24 24 24 24 24 24 24 24 24 24 24 367 367 367 24 24 24 24 24 24 24 3 367 24 24 3 24 24 24 24 24 24 24 24 24 24 24 24 24 35 26 26 36 35 27 9 1 28 24 24 29 5 5 5 5 5 5 
5 5 5 5 5 5 5 5 5 28 24 24 24 24 24 24 24 24 3 24 24 24 24 24 24 24 24 24 24 24 24 24 24 24 24 24 24 24 24 24 24 24 24 24 24 24 24 24 24 24 24 24 24 24 367 24 367 24 24 24 24 24 24 24 24 24 24 24 24 24 24 24 24 367 3 24 24 3 24 24 367 24 24 24 24 3 33 32 9 9 28 24 24 29 5 5 5 5 5 5 
5 5 5 5 5 5 5 5 5 28 24 3 24 24 24 24 24 24 24 24 24 24 24 24 24 24 24 24 24 24 3 24 24 24 24 24 24 24 3 3 24 24 367 24 24 24 24 24 24 24 24 24 24 24 367 24 24 24 24 24 24 24 24 24 24 24 24 24 24 24 24 24 24 24 24 24 24 24 24 367 367 367 24 24 24 24 29 9 9 9 28 24 24 29 5 5 5 5 5 5 
5 5 5 5 5 5 5 5 5 28 24 24 24 24 24 24 24 24 24 24 24 24 367 24 24 24 24 24 24 24 24 24 24 3 24 24 24 24 24 24 24 24 3 367 24 24 3 24 24 24 3 24 24 24 24 367 24 24 3 24 24 3 24 24 24 3 24 24 24 24 24 24 24 24 24 24 24 24 24 367 24 24 24 24 24 33 32 1 9 25 36 24 33 32 5 5 5 5 5 5 
5 5 5 5 5 5 5 5 5 28 24 24 24 24 24 3 24 24 24 24 24 367 367 24 24 24 3 24 24 24 24 24 24 24 24 24 24 24 24 24 367 367 367 24 24 24 24 24 24 24 24 24 24 24 24 24 24 24 24 24 24 24 24 24 24 24 24 24 24 24 24 24 24 24 24 24 24 24 3 24 24 24 24 3 24 29 9 9 25 36 24 24 29 5 5 5 5 5 5 5 
5 5 5 5 5 5 5 5 5 28 24 24 24 24 24 24 24 24 24 367 24 367 24 24 24 24 24 24 24 24 24 24 24 24 24 24 24 24 3 24 24 24 367 24 3 24 24 24 24 24 24 3 24 24 24 24 3 24 24 24 24 24 24 367 24 24 24 24 24 24 3 24 24 24 24 24 24 24 24 24 24 24 24 24 24 35 26 26 36 3 3 24 29 5 5 5 5 5 5 5 
5 5 5 5 5 5 5 5 5 28 24 24 24 24 24 24 24 24 24 24 24 24 24 24 3 24 24 24 24 3 24 24 24 367 3 24 24 24 24 24 24 24 24 24 24 24 24 24 24 24 24 24 24 24 24 24 24 24 24 24 3 24 24 24 24 24 3 24 24 24 24 24 24 24 24 24 24 24 24 24 24 24 24 24 24 24 24 24 24 24 24 24 29 5 5 5 5 5 5 5 
5 5 5 5 5 5 5 5 5 28 24 24 367 24 3 24 24 24 24 24 24 24 24 24 24 24 24 24 24 24 24 24 24 367 367 24 24 24 3 24 24 24 24 24 24 3 24 24 24 24 24 24 3 24 24 24 3 24 24 24 24 24 24 24 24 24 24 24 24 24 24 24 24 24 24 24 24 24 24 24 24 24 3 24 24 3 24 24 24 24 24 24 29 5 5 5 5 5 5 5 
5 5 5 5 5 5 5 5 5 28 24 24 367 24 24 24 24 24 3 24 24 24 24 3 33 31 31 34 24 24 24 3 24 24 24 24 24 24 24 24 24 3 24 24 24 24 24 3 24 24 24 24 24 24 24 24 24 24 24 24 24 3 24 24 24 24 24 24 24 24 24 24 3 24 24 24 33 31 31 34 24 24 24 24 24 24 24 24 3 24 24 33 32 5 5 5 5 5 5 5 
5 5 5 5 5 5 5 5 5 28 24 24 24 24 24 24 24 24 24 24 24 24 24 33 32 9 9 30 34 24 24 24 24 24 24 24 24 24 24 24 24 24 24 24 24 24 24 24 24 24 24 24 24 24 3 3 24 24 24 24 24 24 24 24 24 24 24 24 24 367 24 24 24 24 24 33 32 9 9 30 34 24 24 24 24 367 24 24 24 24 24 29 5 5 5 5 5 5 5 5 
5 5 5 5 5 5 5 1 5 28 24 24 3 24 24 24 24 24 24 24 24 24 33 32 9 9 1 9 30 34 24 24 24 24 3 24 24 24 24 24 24 3 24 24 367 3 24 24 3 24 24 24 24 24 24 24 24 24 24 24 24 24 24 24 24 24 3 367 24 24 24 24 24 24 33 32 9 9 1 9 28 24 24 24 367 367 24 24 24 3 24 29 5 5 5 5 5 5 5 5 
5 5 5 5 5 5 5 9 9 28 24 24 24 24 24 24 3 24 24 24 24 24 29 9 9 9 9 9 9 30 34 3 24 24 24 24 24 3 24 24 24 24 24 24 367 24 24 24 24 24 24 24 24 3 24 24 24 24 24 24 24 24 24 24 3 24 24 24 367 24 3 24 24 33 32 9 9 9 9 9 28 24 24 24 24 367 24 24 24 367 24 29 5 5 5 5 5 5 5 5 
5 5 5 5 5 5 5 9 9 30 34 24 24 24 24 24 24 24 3 24 24 24 29 9 1 9 9 1 9 9 28 24 24 24 24 24 24 24 24 24 24 24 24 367 24 367 24 24 24 24 24 3 24 24 24 24 24 24 3 24 24 24 24 24 24 24 24 24 24 24 24 24 24 29 9 1 9 9 9 25 36 24 3 24 24 24 3 24 24 24 24 29 5 5 5 5 5 5 5 5 
5 5 5 5 5 5 5 9 1 9 28 24 24 3 24 24 24 24 24 24 24 24 29 9 9 9 1 9 9 9 28 24 24 24 24 24 24 24 3 24 24 24 24 24 367 24 24 3 24 24 24 24 24 24 24 24 24 24 24 24 24 3 24 24 24 24 24 24 24 24 24 24 24 35 27 9 1 9 25 36 24 24 24 24 24 24 24 24 24 24 33 32 5 5 5 5 5 5 5 5 
5 5 5 5 5 5 9 1 9 9 28 24 24 24 24 24 24 24 24 24 24 24 29 1 9 9 9 9 1 9 28 24 24 24 3 24 24 24 24 24 24 3 24 24 3 24 24 24 24 24 24 24 3 24 24 24 24 24 24 24 24 24 24 24 3 24 24 3 24 24 24 24 24 3 35 26 26 26 36 24 3 24 24 367 24 24 24 24 24 24 29 5 5 5 5 5 5 5 5 5 
5 5 5 5 5 5 5 9 1 5 28 24 24 24 24 24 24 24 24 24 24 24 35 27 9 9 1 9 9 9 28 24 3 24 3 24 367 24 24 24 24 24 24 24 24 24 24 24 24 3 367 24 24 24 24 24 3 24 24 24 24 24 24 24 24 24 24 24 24 3 24 24 24 24 24 24 24 24 24 24 24 24 24 367 24 24 3 24 24 24 29 5 5 5 5 5 5 5 5 5 
5 5 5 5 5 5 5 5 5 5 28 24 3 24 24 24 3 24 24 3 24 24 24 35 27 9 9 9 9 25 36 24 24 24 24 24 24 367 24 24 3 24 24 24 24 24 24 24 24 24 367 367 24 24 24 24 24 24 24 24 3 24 24 24 24 24 24 24 24 24 24 24 24 24 367 24 24 24 24 24 24 3 24 24 367 24 24 24 24 24 29 5 5 5 5 5 5 5 5 5 
5 5 5 5 5 5 5 5 5 5 28 24 24 24 24 24 24 24 24 24 24 24 24 24 35 26 26 26 26 36 24 24 24 24 24 24 24 24 24 24 24 24 24 367 24 24 3 24 24 24 367 367 24 24 24 24 24 24 24 24 24 24 24 24 24 24 24 3 24 24 24 24 24 24 24 3 24 24 24 24 24 24 3 24 24 24 24 3 24 33 32 5 5 5 5 5 5 5 5 5 
5 5 5 5 5 5 5 5 5 5 30 34 24 24 24 24 24 24 24 24 24 24 3 24 24 24 24 24 24 24 24 24 24 24 24 3 24 24 24 24 24 24 24 367 24 24 24 24 24 24 24 24 3 24 24 3 24 24 24 24 24 24 367 24 3 24 24 24 24 24 24 24 24 24 24 24 24 24 24 367 24 24 24 24 24 24 367 24 24 29 5 5 5 5 5 5 5 5 5 5 
5 5 5 5 5 5 5 5 5 5 5 30 34 24 3 24 24 24 3 24 367 24 24 24 24 24 24 24 24 24 24 24 24 24 24 24 24 24 3 24 24 24 367 3 367 367 3 24 24 24 367 24 24 24 3 24 24 24 24 3 24 367 24 367 24 24 24 24 24 24 24 3 3 24 24 24 24 24 24 24 24 24 24 24 24 24 3 24 33 32 5 5 5 5 5 5 5 5 5 5 
5 5 5 5 5 5 5 5 5 5 5 5 30 31 31 34 24 24 24 24 24 367 24 24 24 24 24 24 24 24 24 24 24 24 24 24 24 24 24 24 3 24 24 367 24 24 24 24 24 24 3 24 24 24 24 24 24 24 24 24 24 24 367 367 24 24 24 24 24 24 24 24 24 3 24 24 24 3 24 24 24 3 24 24 24 24 24 33 32 5 5 5 5 5 5 5 5 5 5 5 
5 5 5 5 5 5 5 5 5 5 5 5 5 5 5 30 31 31 31 31 34 24 24 24 24 24 3 24 24 24 24 3 24 24 3 24 24 24 24 24 24 24 24 24 367 24 3 24 24 24 24 24 24 24 33 31 31 31 34 24 24 24 3 24 24 24 24 24 24 367 24 24 24 24 24 24 24 24 24 24 24 24 24 24 24 24 33 32 5 5 5 5 5 5 5 5 5 5 5 5 
5 5 5 5 5 5 5 5 5 5 5 5 5 5 5 5 9 9 1 9 30 31 31 31 31 31 31 31 31 31 31 31 31 34 24 24 3 24 24 24 24 24 24 3 24 24 24 24 24 24 24 24 33 31 32 18 16 19 30 31 31 34 24 24 24 24 24 3 24 367 24 24 24 24 24 24 24 24 24 24 24 24 24 24 3 24 29 5 5 5 5 5 5 5 5 5 5 5 5 5 
5 5 5 5 5 5 5 5 5 5 5 5 5 5 5 5 5 1 9 9 9 1 9 5 5 5 5 5 5 5 5 5 5 30 34 24 24 24 24 24 24 24 24 24 24 24 24 24 3 33 31 31 32 9 9 14 6 13 1 9 9 30 31 31 31 34 24 24 367 24 24 24 3 24 24 24 24 367 24 24 3 24 24 24 24 33 32 5 5 5 5 5 5 5 5 5 5 5 5 5 
5 5 5 5 5 5 5 5 5 5 5 5 5 5 5 5 5 5 9 1 9 9 5 5 5 5 5 5 5 5 5 5 5 5 30 31 34 24 24 3 24 24 33 31 31 31 31 31 31 32 5 9 1 9 9 114 115 116 9 1 9 9 9 5 5 30 31 34 24 24 24 24 24 24 24 24 3 24 24 24 24 24 24 33 31 32 9 5 5 5 5 5 5 5 5 5 5 5 5 5 
5 5 5 5 5 5 5 5 5 5 5 5 5 5 5 5 5 5 5 5 5 5 5 5 5 5 5 5 5 5 5 5 5 5 5 5 30 31 31 31 31 31 32 9 1 5 5 5 5 5 5 5 9 1 186 117 118 119 188 9 9 1 9 5 5 5 5 30 31 31 31 31 31 31 31 31 31 31 31 31 31 31 31 32 9 1 9 5 5 5 5 5 5 5 5 5 5 5 5 5 
5 5 5 5 5 5 5 5 5 5 5 5 5 5 5 5 5 5 5 5 5 5 5 5 5 5 5 5 5 5 5 5 5 5 5 5 5 5 5 5 9 9 9 1 9 5 5 5 5 5 5 5 5 5 190 191 191 191 192 9 9 5 5 5 5 5 5 5 5 5 5 5 5 5 5 5 5 5 5 5 5 5 5 9 1 9 5 5 5 5 5 5 5 5 5 5 5 5 5 5 
5 5 5 5 5 5 5 5 5 5 5 5 5 5 5 5 5 5 5 5 5 5 5 5 5 5 5 5 5 5 5 5 5 5 5 5 5 5 5 5 5 1 9 5 5 5 5 5 5 5 5 5 5 5 195 196 196 196 197 5 5 5 5 5 5 5 5 5 5 5 5 5 5 5 5 5 5 5 5 5 5 5 5 5 5 5 5 5 5 5 5 5 5 5 5 5 5 5 5 5 
5 5 5 5 5 5 5 5 5 5 5 5 5 5 5 5 5 5 5 5 5 5 5 5 5 5 5 5 5 5 5 5 5 5 5 5 5 5 5 5 5 5 5 5 5 5 5 5 5 5 5 5 5 5 126 127 128 129 130 5 5 5 5 5 5 5 5 5 5 5 5 5 5 5 5 5 5 5 5 5 5 5 5 5 5 5 5 5 5 5 5 5 5 5 5 5 5 5 5 5 
5 5 5 5 5 5 5 5 5 5 5 5 5 5 5 5 5 5 5 5 5 5 5 5 5 5 5 5 5 5 5 5 5 5 5 5 5 5 5 5 5 5 5 5 5 5 5 5 5 5 5 5 5 5 131 132 133 134 135 5 5 5 5 5 5 5 5 5 5 5 5 5 5 5 5 5 5 5 5 5 5 5 5 5 5 5 5 5 5 5 5 5 5 5 5 5 5 5 5 5 
5 5 5 5 5 5 5 5 5 5 5 5 5 5 5 5 5 5 5 5 5 5 5 5 5 5 5 5 5 5 5 5 5 5 5 5 5 5 5 5 5 5 5 5 5 5 5 5 5 5 5 5 5 5 5 136 137 138 5 5 5 5 5 5 5 5 5 5 5 5 5 5 5 5 5 5 5 5 5 5 5 5 5 5 5 5 5 5 5 5 5 5 5 5 5 5 5 5 5 5 
5 5 5 5 5 5 5 5 5 5 5 5 5 5 5 5 5 5 5 5 5 5 5 5 5 5 5 5 5 5 5 5 5 5 5 5 5 5 5 5 5 5 5 5 5 5 5 5 5 5 5 5 5 5 5 5 5 5 5 5 5 5 5 5 5 5 5 5 5 5 5 5 5 5 5 5 5 5 5 5 5 5 5 5 5 5 5 5 5 5 5 5 5 5 5 5 5 5 5 5 
5 5 5 5 5 5 5 5 5 5 5 5 5 5 5 5 5 5 5 5 5 5 5 5 5 5 5 5 5 5 5 5 5 5 5 5 5 5 5 5 5 5 5 5 5 5 5 5 5 5 5 5 5 5 5 5 5 5 5 5 5 5 5 5 5 5 5 5 5 5 5 5 5 5 5 5 5 5 5 5 5 5 5 5 5 5 5 5 5 5 5 5 5 5 5 5 5 5 5 5 
5 5 5 5 5 5 5 5 5 5 5 5 5 5 5 5 5 5 5 5 5 5 5 5 5 5 5 5 5 5 5 5 5 5 5 5 5 5 5 5 5 5 5 5 5 5 5 5 5 5 5 5 5 5 5 5 5 5 5 5 5 5 5 5 5 5 5 5 5 5 5 5 5 5 5 5 5 5 5 5 5 5 5 5 5 5 5 5 5 5 5 5 5 5 5 5 5 5 5 5 
5 5 5 5 5 5 5 5 5 5 5 5 5 5 5 5 5 5 5 5 5 5 5 5 5 5 5 5 5 5 5 5 5 5 5 5 5 5 5 5 5 5 5 5 5 5 5 5 5 5 5 5 5 5 5 5 5 5 5 5 5 5 5 5 5 5 5 5 5 5 5 5 5 5 5 5 5 5 5 5 5 5 5 5 5 5 5 5 5 5 5 5 5 5 5 5 5 5 5 5 
5 5 5 5 5 5 5 5 5 5 5 5 5 5 5 5 5 5 5 5 5 5 5 5 5 5 5 5 5 5 5 5 5 5 5 5 5 5 5 5 5 5 5 5 5 5 5 5 5 5 5 5 5 5 5 5 5 5 5 5 5 5 5 5 5 5 5 5 5 5 5 5 5 5 5 5 5 5 5 5 5 5 5 5 5 5 5 5 5 5 5 5 5 5 5 5 5 5 5 5 
5 5 5 5 5 5 5 5 5 5 5 5 5 5 5 5 5 5 5 5 5 5 5 5 5 5 5 5 5 5 5 5 5 5 5 5 5 5 5 5 5 5 5 5 5 5 5 5 5 5 5 5 5 5 5 5 5 5 5 5 5 5 5 5 5 5 5 5 5 5 5 5 5 5 5 5 5 5 5 5 5 5 5 5 5 5 5 5 5 5 5 5 5 5 5 5 5 5 5 5 
5 5 5 5 5 5 5 5 5 5 5 5 5 5 5 5 5 5 5 5 5 5 5 5 5 5 5 5 5 5 5 5 5 5 5 5 5 5 5 5 5 5 5 5 5 5 5 5 5 5 5 5 5 5 5 5 5 5 5 5 5 5 5 5 5 5 5 5 5 5 5 5 5 5 5 5 5 5 5 5 5 5 5 5 5 5 5 5 5 5 5 5 5 5 5 5 5 5 5 5 
5 5 5 5 5 5 5 5 5 5 5 5 5 5 5 5 5 5 5 5 5 5 5 5 5 5 5 5 5 5 5 5 5 5 5 5 5 5 5 5 5 5 5 5 5 5 5 5 5 5 5 5 5 5 5 5 5 5 5 5 5 5 5 5 5 5 5 5 5 5 5 5 5 5 5 5 5 5 5 5 5 5 5 5 5 5 5 5 5 5 5 5 5 5 5 5 5 5 5 5 
5 5 5 5 5 5 5 5 5 5 5 5 5 5 5 5 5 5 5 5 5 5 5 5 5 5 5 5 5 5 5 5 5 5 5 5 5 5 5 5 5 5 5 5 5 5 5 5 5 5 5 5 5 5 5 5 5 5 5 5 5 5 5 5 5 5 5 5 5 5 5 5 5 5 5 5 5 5 5 5 5 5 5 5 5 5 5 5 5 5 5 5 5 5 5 5 5 5 5 5 
5 5 5 5 5 5 5 5 5 5 5 5 5 5 5 5 5 5 5 5 5 5 5 5 5 5 5 5 5 5 5 5 5 5 5 5 5 5 5 5 5 5 5 5 5 5 5 5 5 5 5 5 5 5 5 5 5 5 5 5 5 5 5 5 5 5 5 5 5 5 5 5 5 5 5 5 5 5 5 5 5 5 5 5 5 5 5 5 5 5 5 5 5 5 5 5 5 5 5 5 
5 5 5 5 5 5 5 5 5 5 5 5 5 5 5 5 5 5 5 5 5 5 5 5 5 5 5 5 5 5 5 5 5 5 5 5 5 5 5 5 5 5 5 5 5 5 5 5 5 5 5 5 5 5 5 5 5 5 5 5 5 5 5 5 5 5 5 5 5 5 5 5 5 5 5 5 5 5 5 5 5 5 5 5 5 5 5 5 5 5 5 5 5 5 5 5 5 5 5 5 
5 5 5 5 5 5 5 5 5 5 5 5 5 5 5 5 5 5 5 5 5 5 5 5 5 5 5 5 5 5 5 5 5 5 5 5 5 5 5 5 5 5 5 5 5 5 5 5 5 5 5 5 5 5 5 5 5 5 5 5 5 5 5 5 5 5 5 5 5 5 5 5 5 5 5 5 5 5 5 5 5 5 5 5 5 5 5 5 5 5 5 5 5 5 5 5 5 5 5 5 
5 5 5 5 5 5 5 5 5 5 5 5 5 5 5 5 5 5 5 5 5 5 5 5 5 5 5 5 5 5 5 5 5 5 5 5 5 5 5 5 5 5 5 5 5 5 5 5 5 5 5 5 5 5 5 5 5 5 5 5 5 5 5 5 5 5 5 5 5 5 5 5 5 5 5 5 5 5 5 5 5 5 5 5 5 5 5 5 5 5 5 5 5 5 5 5 5 5 5 5 
5 5 5 5 5 5 5 5 5 5 5 5 5 5 5 5 5 5 5 5 5 5 5 5 5 5 5 5 5 5 5 5 5 5 5 5 5 5 5 5 5 5 5 5 5 5 5 5 5 5 5 5 5 5 5 5 5 5 5 5 5 5 5 5 5 5 5 5 5 5 5 5 5 5 5 5 5 5 5 5 5 5 5 5 5 5 5 5 5 5 5 5 5 5 5 5 5 5 5 5 
5 5 5 5 5 5 5 5 5 5 5 5 5 5 5 5 5 5 5 5 5 5 5 5 5 5 5 5 5 5 5 5 5 5 5 5 5 5 5 5 5 5 5 5 5 5 5 5 5 5 5 5 5 5 5 5 5 5 5 5 5 5 5 5 5 5 5 5 5 5 5 5 5 5 5 5 5 5 5 5 5 5 5 5 5 5 5 5 5 5 5 5 5 5 5 5 5 5 5 5 
5 5 5 5 5 5 5 5 5 5 5 5 5 5 5 5 5 5 5 5 5 5 5 5 5 5 5 5 5 5 5 5 5 5 5 5 5 5 5 5 5 5 5 5 5 5 5 5 5 5 5 5 5 5 5 5 5 5 5 5 5 5 5 5 5 5 5 5 5 5 5 5 5 5 5 5 5 5 5 5 5 5 5 5 5 5 5 5 5 5 5 5 5 5 5 5 5 5 5 5 
5 5 5 5 5 5 5 5 5 5 5 5 5 5 5 5 5 5 5 5 5 5 5 5 5 5 5 5 5 5 5 5 5 5 5 5 5 5 5 5 5 5 5 5 5 5 5 5 5 5 5 5 5 5 5 5 5 5 5 5 5 5 5 5 5 5 5 5 5 5 5 5 5 5 5 5 5 5 5 5 5 5 5 5 5 5 5 5 5 5 5 5 5 5 5 5 5 5 5 5 
5 5 5 5 5 5 5 5 5 5 5 5 5 5 5 5 5 5 5 5 5 5 5 5 5 5 5 5 5 5 5 5 5 5 5 5 5 5 5 5 5 5 5 5 5 5 5 5 5 5 5 5 5 5 5 5 5 5 5 5 5 5 5 5 5 5 5 5 5 5 5 5 5 5 5 5 5 5 5 5 5 5 5 5 5 5 5 5 5 5 5 5 5 5 5 5 5 5 5 5 
5 5 5 5 5 5 5 5 5 5 5 5 5 5 5 5 5 5 5 5 5 5 5 5 5 5 5 5 5 5 5 5 5 5 5 5 5 5 5 5 5 5 5 5 5 5 5 5 5 5 5 5 5 5 5 5 5 5 5 5 5 5 5 5 5 5 5 5 5 5 5 5 5 5 5 5 5 5 5 5 5 5 5 5 5 5 5 5 5 5 5 5 5 5 5 5 5 5 5 5 
5 5 5 5 5 5 5 5 5 5 5 5 5 5 5 5 5 5 5 5 5 5 5 5 5 5 5 5 5 5 5 5 5 5 5 5 5 5 5 5 5 5 5 5 5 5 5 5 5 5 5 5 5 5 5 5 5 5 5 5 5 5 5 5 5 5 5 5 5 5 5 5 5 5 5 5 5 5 5 5 5 5 5 5 5 5 5 5 5 5 5 5 5 5 5 5 5 5 5 5 
