5 5 5 5 5 5 5 5 5 5 5 5 5 5 5 5 5 5 5 5 5 5 5 5 5 5 5 5 5 5 5 5 5 5 5 5 5 5 5 5 5 5 5 5 5 5 5 5 5 5 5 5 5 5 5 5 5 5 5 5 5 5 5 5 5 5 5 5 5 5 5 5 5 5 5 5 5 5 5 5 5 5 5 5 5 5 5 5 5 5 5 5 5 5 5 5 5 5 5 5 
5 5 5 5 5 5 5 5 5 5 5 5 5 5 5 5 5 5 5 5 5 5 5 5 5 5 5 5 5 5 5 5 5 5 5 5 5 5 5 5 5 5 5 5 5 5 5 5 5 5 5 5 5 5 5 5 5 5 5 5 5 5 5 5 5 5 5 5 5 5 5 5 5 5 5 5 5 5 5 5 5 5 5 5 5 5 5 5 5 5 5 5 5 5 5 5 5 5 5 5 
5 5 5 5 5 5 5 5 5 5 5 5 5 5 5 5 5 5 5 5 5 5 5 5 5 5 5 5 5 5 5 5 5 5 5 5 5 5 5 5 5 5 5 5 5 5 5 5 5 5 5 5 5 5 5 5 5 5 5 5 5 5 5 5 5 5 5 5 5 5 5 5 5 5 5 5 5 5 5 5 5 5 5 5 5 5 5 5 5 5 5 5 5 5 5 5 5 5 5 5 
5 5 5 5 5 5 5 5 5 5 5 5 5 5 5 5 5 5 5 5 5 5 5 5 5 5 5 5 5 5 5 5 5 5 5 5 5 5 5 5 5 5 5 5 5 5 5 5 5 5 5 5 5 5 5 5 5 5 5 5 5 5 5 5 5 5 5 5 5 5 5 5 5 5 5 5 5 5 5 5 5 5 5 5 5 5 5 5 5 5 5 5 5 5 5 5 5 5 5 5 
5 5 5 5 5 5 5 5 5 5 5 5 5 5 5 5 5 5 5 5 5 5 5 5 5 5 5 5 5 5 5 5 5 5 5 5 5 5 5 5 5 5 5 5 5 5 5 5 5 5 5 5 5 5 5 5 5 5 5 5 5 5 5 5 5 5 5 5 5 5 5 5 5 5 5 5 5 5 5 5 5 5 5 5 5 5 5 5 5 5 5 5 5 5 5 5 5 5 5 5 
5 5 5 5 5 5 5 5 5 5 5 5 5 5 5 5 5 5 5 5 5 5 5 5 5 5 5 5 5 5 5 5 5 5 5 5 5 5 5 5 5 5 5 5 5 5 5 5 5 5 5 5 5 5 5 5 5 5 5 5 5 5 5 5 5 5 5 5 5 5 5 5 5 5 5 5 5 5 5 5 5 5 5 5 5 5 5 5 5 5 5 5 5 5 5 5 5 5 5 5 
5 5 5 5 5 5 5 5 5 5 5 5 5 5 5 5 5 5 5 5 5 5 5 5 5 5 5 5 5 5 5 5 5 5 5 5 5 5 5 5 5 5 5 5 5 5 5 5 5 5 5 5 5 5 5 5 5 5 5 5 5 5 5 5 5 5 5 5 5 5 5 5 5 5 5 5 5 5 5 5 5 5 5 5 5 5 5 5 5 5 5 5 5 5 5 5 5 5 5 5 
5 5 5 5 5 5 5 5 5 5 5 5 5 5 5 5 5 5 5 5 5 5 5 5 5 5 5 5 5 5 5 5 5 5 5 5 5 5 5 5 5 5 9 9 9 9 9 9 5 5 5 5 5 5 5 5 5 5 5 5 5 5 5 5 5 5 5 5 5 5 5 5 5 5 5 5 5 5 5 5 5 5 5 5 5 5 5 5 5 5 5 5 5 5 5 5 5 5 5 5 
5 5 5 5 5 5 5 5 5 5 5 5 5 5 5 5 5 5 5 5 5 5 5 5 5 5 5 5 5 5 5 5 5 5 5 5 5 5 5 5 5 9 9 9 9 9 9 9 9 5 5 5 5 5 5 5 5 5 5 5 5 5 5 5 5 5 5 5 5 5 5 5 5 5 5 5 5 5 5 5 5 9 9 9 5 5 5 5 5 5 5 5 5 5 5 5 5 5 5 5 
5 5 5 5 5 5 5 5 5 5 5 5 5 5 5 5 5 5 5 5 5 5 5 5 5 5 5 5 5 5 5 5 5 5 5 5 5 5 5 5 5 9 9 9 18 16 19 9 9 5 5 5 5 5 5 5 5 5 5 5 5 5 5 5 5 5 5 5 5 5 5 5 5 5 5 5 5 5 5 5 5 9 9 9 5 5 5 5 5 5 5 5 5 5 5 5 5 5 5 5 
5 5 5 5 5 5 5 5 5 5 5 5 5 5 5 5 5 5 5 5 5 5 5 5 5 5 5 5 5 5 5 5 5 5 5 5 5 5 5 5 5 5 1 9 14 6 13 9 1 9 5 5 5 5 5 5 5 5 5 5 5 5 5 5 5 5 5 5 5 5 5 5 5 5 5 5 5 5 5 5 131 132 133 134 135 5 5 5 5 5 5 5 5 5 5 5 5 5 5 5 
5 5 5 5 5 5 5 5 5 5 5 5 5 5 5 5 5 5 5 5 5 5 5 5 5 5 5 5 5 5 5 5 5 5 5 5 5 5 5 5 5 5 9 9 14 6 13 9 9 5 5 5 5 5 5 5 5 5 5 5 5 5 5 5 5 5 5 5 5 5 5 5 5 5 5 5 5 5 5 5 5 136 137 138 5 5 5 5 5 5 5 5 5 5 5 5 5 5 5 5 
5 5 5 5 5 5 5 5 5 5 5 5 5 5 5 5 5 5 5 5 5 5 5 5 5 5 5 5 5 5 5 5 5 5 5 5 5 5 5 5 5 5 9 1 14 6 13 1 9 5 5 5 5 5 5 5 5 5 5 5 5 5 5 5 5 5 5 5 5 5 5 5 5 5 5 5 5 5 5 5 5 9 9 1 5 5 5 5 5 5 5 5 5 5 5 5 5 5 5 5 
5 5 5 5 5 5 5 5 5 5 5 5 5 5 5 5 5 5 5 5 5 5 5 5 5 5 5 5 5 5 5 5 5 5 5 5 5 5 5 5 5 5 5 5 114 115 116 5 5 5 5 5 5 5 5 5 5 5 5 5 5 5 5 5 5 5 5 5 5 5 5 5 5 5 5 5 5 5 5 5 5 9 9 9 5 5 5 5 5 5 5 5 5 5 5 5 5 5 5 5 
5 5 5 5 5 5 5 5 5 5 5 5 5 5 5 5 5 5 5 5 5 5 5 5 5 5 5 5 5 5 5 5 5 5 5 5 5 5 5 5 5 5 5 117 118 118 118 119 5 5 5 5 5 5 5 5 5 5 5 5 5 5 5 5 5 5 5 5 5 5 5 5 5 5 5 5 5 5 5 5 9 1 9 9 5 5 5 5 5 5 5 5 5 5 5 5 5 5 5 5 
5 5 5 5 5 5 5 5 5 5 5 5 5 5 5 5 5 5 5 5 5 5 5 5 5 5 5 5 5 5 5 5 5 5 5 5 5 5 5 5 5 5 5 120 121 121 121 122 5 5 5 5 5 5 5 5 5 5 5 5 5 5 5 5 5 5 5 5 5 5 5 5 5 5 5 5 5 5 5 5 9 9 1 9 5 5 5 5 5 5 5 5 5 5 5 5 5 5 5 5 
5 5 5 5 5 5 5 5 5 5 5 5 5 5 5 5 5 5 5 5 5 5 5 5 5 5 5 5 5 5 5 5 5 5 5 5 5 5 5 5 5 5 5 123 124 124 124 125 5 5 5 5 5 5 5 5 5 5 5 1 9 9 5 5 5 5 5 5 5 5 5 5 5 5 5 5 5 5 5 5 9 9 9 1 5 5 5 5 5 5 5 5 5 5 5 5 5 5 5 5 
5 5 5 5 5 5 5 5 5 5 5 5 5 5 5 5 5 5 5 5 5 5 5 5 5 5 5 5 5 5 5 5 5 5 5 5 5 5 5 5 5 5 5 126 127 128 129 130 5 5 5 5 5 5 5 5 5 5 5 7 249 7 5 5 5 5 5 5 5 5 5 5 5 5 5 5 5 5 5 5 9 9 9 5 5 5 5 5 5 5 5 5 5 5 5 5 5 5 5 9 
5 5 5 5 5 5 5 5 5 5 5 5 5 5 5 5 5 5 5 5 5 5 5 5 5 5 5 5 5 5 5 5 5 5 5 5 5 5 5 5 5 5 5 131 132 133 134 135 5 5 5 5 5 5 5 5 5 5 5 7 9 1 5 5 5 5 5 5 5 5 5 5 5 5 5 5 5 5 5 1 9 9 1 5 5 5 5 5 5 5 5 5 5 5 5 5 5 5 5 5 
5 5 5 5 5 5 5 5 5 5 5 5 5 5 5 5 5 5 5 5 5 5 5 5 5 5 5 5 5 5 5 5 5 5 5 5 5 5 5 5 5 5 5 5 136 137 138 5 5 7 1 7 5 1 7 1 5 5 1 9 1 5 5 7 249 9 5 5 5 5 5 5 5 5 5 5 5 5 9 9 1 9 5 5 5 5 5 5 5 5 5 5 5 5 5 5 5 5 5 5 
5 5 5 5 5 5 5 5 5 5 5 5 5 5 5 5 5 5 5 5 5 5 5 5 5 5 5 5 5 5 5 5 5 5 5 5 5 5 5 5 5 5 5 7 14 6 13 1 5 7 249 9 5 7 249 7 5 5 41 40 42 5 5 9 9 7 5 5 5 5 5 5 5 5 5 5 5 5 9 9 9 5 5 5 5 5 5 5 5 5 5 5 5 5 5 5 5 5 5 5 
5 5 5 5 5 5 5 5 5 5 5 5 5 5 5 5 5 5 5 5 5 5 5 5 5 5 5 5 5 5 5 5 5 5 5 1 7 9 7 1 9 7 5 9 20 11 21 7 5 9 7 1 5 7 9 7 5 5 9 1 7 9 1 7 1 9 5 5 5 5 5 5 5 5 5 5 5 9 1 9 5 5 5 5 5 5 5 5 5 5 5 5 5 5 5 5 5 5 5 5 
5 5 5 5 5 5 5 5 5 5 5 5 5 5 5 5 5 5 5 5 5 5 5 5 5 5 5 5 5 5 5 7 9 7 9 7 9 1 9 7 7 1 9 7 7 7 9 9 5 5 9 9 5 9 1 7 5 1 7 9 9 7 9 1 5 5 7 1 5 5 5 5 5 5 249 9 1 9 9 9 5 5 5 5 5 5 5 5 5 5 5 5 5 5 5 5 5 5 5 5 
5 5 5 5 5 5 5 5 5 5 5 5 5 5 5 5 5 5 5 5 5 5 5 5 5 5 5 5 5 1 9 9 7 1 7 1 7 9 1 9 7 9 5 9 7 9 7 1 5 5 1 7 5 7 7 1 47 9 9 7 1 9 1 5 9 7 1 7 9 5 5 5 5 5 9 9 9 9 1 9 5 5 5 5 5 5 5 5 5 5 5 5 5 5 5 5 5 5 5 5 
5 5 5 5 5 5 5 5 5 5 5 5 5 5 5 5 5 5 5 5 5 5 5 5 5 5 5 9 7 7 9 7 1 9 7 9 1 7 7 9 1 7 5 1 7 9 7 9 5 5 7 9 5 5 1 9 46 1 7 9 9 7 5 7 1 7 7 7 1 7 9 5 5 5 5 9 1 9 9 5 5 5 5 5 5 5 5 5 5 5 5 5 5 5 5 5 5 5 5 5 
5 5 5 5 5 5 5 5 5 5 5 5 5 5 5 5 5 5 5 5 5 5 5 5 5 5 5 1 9 9 7 5 5 5 5 5 5 5 5 5 5 5 5 5 5 5 5 5 5 5 9 1 9 5 7 9 48 7 9 7 1 5 9 7 7 7 7 7 7 9 7 1 7 5 9 1 9 1 9 5 5 5 5 5 5 5 5 5 5 5 5 5 5 5 5 5 5 5 5 5 
5 5 5 5 5 5 5 5 5 5 5 5 5 5 5 5 5 5 5 5 5 5 5 5 5 5 9 9 7 1 5 5 5 5 5 5 5 5 5 5 5 5 5 5 5 5 5 5 5 5 1 9 7 5 5 5 5 9 1 9 9 5 1 7 9 1 7 9 7 7 9 7 9 9 5 9 249 9 5 5 5 5 5 5 5 5 5 5 5 5 5 5 5 5 5 5 5 5 5 5 
5 5 5 5 5 5 5 5 5 5 5 5 5 5 5 5 5 5 5 5 5 5 5 5 5 9 7 1 9 7 5 7 9 1 7 5 5 5 5 5 5 5 5 5 5 5 5 5 5 5 5 7 7 9 7 5 5 5 7 7 5 1 7 1 7 7 5 5 5 1 7 9 7 1 9 5 5 5 5 5 5 5 5 5 5 5 5 5 5 5 5 5 5 5 5 5 5 5 5 5 
5 5 5 5 5 5 5 5 5 5 5 5 5 5 5 5 5 5 5 5 5 5 5 5 5 1 9 9 7 7 5 9 249 7 9 7 7 7 5 5 5 5 5 5 5 5 5 5 5 5 5 5 1 7 9 7 5 5 5 5 5 9 7 9 7 7 7 1 9 5 9 7 7 9 7 5 5 5 5 5 5 5 5 5 5 5 5 5 5 5 5 5 5 5 5 5 5 5 5 5 
5 5 5 5 5 5 5 5 5 5 5 5 5 5 5 5 5 5 5 5 5 5 5 5 5 9 7 7 9 1 5 1 7 9 1 7 1 9 1 9 7 7 1 5 9 9 1 5 7 1 9 5 5 5 5 7 1 5 5 5 5 7 9 7 7 7 7 7 7 1 5 9 7 7 1 5 5 5 5 5 5 5 5 5 5 5 5 5 5 5 5 5 5 5 5 5 5 5 5 5 
5 5 5 5 5 5 5 5 5 5 5 5 5 5 5 5 5 5 5 5 5 5 5 5 5 7 1 9 7 9 5 5 5 5 7 9 7 9 7 9 1 7 7 5 1 249 7 5 9 249 7 9 1 7 5 1 7 5 5 5 5 7 1 9 9 7 9 7 9 7 5 5 9 7 7 9 5 5 5 5 5 5 5 5 5 5 5 5 5 5 5 5 5 5 5 5 5 5 5 5 
5 5 5 5 5 5 5 5 5 5 5 5 5 5 5 5 5 5 5 5 5 5 5 5 5 9 1 7 5 5 5 5 5 5 5 5 5 5 7 1 9 7 9 5 7 9 7 5 7 9 1 9 7 9 5 7 9 5 5 5 1 9 9 7 1 5 5 9 1 249 7 5 5 1 7 7 9 5 5 5 5 5 5 5 5 5 5 5 5 5 5 5 5 5 5 5 5 5 5 5 
5 5 5 5 5 5 5 5 5 5 5 5 5 5 5 5 5 5 5 5 1 5 5 5 5 1 7 7 5 5 5 5 5 5 5 5 5 5 5 5 9 7 1 44 9 1 9 5 1 7 9 5 41 42 5 9 7 5 5 5 9 7 7 7 9 7 9 5 7 9 5 5 5 9 9 7 1 7 5 5 5 5 5 5 5 5 5 5 5 5 5 5 5 5 5 5 5 5 5 5 
5 5 5 5 5 5 5 5 5 5 5 5 5 5 5 5 5 5 5 1 9 1 5 5 5 7 9 1 5 5 5 1 7 9 7 1 9 5 5 5 7 9 7 43 1 7 9 5 5 5 5 5 7 1 47 7 7 5 5 7 7 7 7 7 7 1 7 9 5 5 5 7 7 5 7 7 7 9 5 5 5 5 5 5 5 5 5 5 5 5 5 5 5 5 5 5 5 5 5 5 
5 5 5 5 5 5 5 5 5 5 5 5 5 5 5 5 5 5 5 7 249 7 9 5 5 9 7 9 1 5 5 7 9 7 1 9 7 9 5 5 7 1 9 43 9 9 1 5 5 5 5 5 1 7 48 9 1 5 5 1 7 7 1 9 7 7 7 1 7 5 1 7 9 5 5 1 7 9 5 5 5 5 5 5 5 5 5 5 5 5 5 5 5 5 5 5 5 5 5 5 
5 5 5 5 5 5 5 5 5 5 5 5 5 5 5 5 5 5 9 9 1 7 9 7 5 5 1 9 7 5 5 5 1 9 9 7 9 1 7 5 9 9 7 45 1 9 7 5 7 9 7 5 38 39 5 5 5 5 5 7 7 7 9 5 5 5 1 7 7 5 7 9 7 1 5 5 9 7 1 5 5 5 5 1 5 5 5 5 5 5 5 5 5 5 5 5 5 5 5 5 
5 5 5 5 5 5 5 5 5 5 5 5 5 5 5 5 5 5 5 5 7 1 7 9 1 5 9 1 9 5 5 5 9 7 7 9 1 7 1 5 1 7 1 5 7 1 9 5 7 1 7 7 1 9 5 5 5 5 1 7 9 7 7 7 9 7 5 7 5 5 1 7 1 7 5 5 7 7 7 5 5 5 5 5 5 5 5 5 5 5 5 5 5 5 5 5 5 5 5 5 
5 5 5 5 5 5 5 5 5 5 5 5 5 5 5 5 5 1 7 5 5 9 9 7 7 5 9 7 9 1 9 7 1 9 1 7 9 7 9 5 9 7 9 5 9 249 7 5 9 249 1 9 7 7 5 5 5 5 9 7 7 1 9 7 7 1 9 5 5 5 7 9 7 7 1 5 1 7 7 5 5 5 5 5 5 5 5 5 5 5 5 5 5 5 5 5 5 5 5 5 
5 5 5 5 5 5 5 5 5 5 5 5 5 5 5 5 5 7 1 9 5 5 7 9 9 5 7 9 1 7 1 9 1 7 9 5 5 5 5 5 7 7 7 5 9 7 9 5 1 7 1 5 5 5 5 5 5 5 7 1 9 5 7 1 7 7 7 5 5 5 9 7 7 7 9 5 7 7 7 5 5 5 5 5 5 5 5 5 5 5 5 5 5 5 5 5 5 5 5 5 
5 5 5 5 5 5 5 5 5 5 5 5 5 5 5 5 5 9 249 7 1 5 1 9 7 5 9 7 7 9 9 7 9 7 1 5 5 5 5 5 1 1 9 5 5 5 5 5 5 5 5 5 5 5 5 5 5 1 7 7 9 5 5 7 1 7 1 7 5 5 7 1 9 9 7 5 7 9 7 1 5 5 5 5 5 5 5 5 5 5 5 5 5 5 5 5 5 5 5 5 
5 5 5 5 5 5 5 5 5 5 5 5 5 5 5 5 5 7 1 9 5 5 9 1 9 5 1 7 1 7 9 9 7 9 7 7 9 1 9 5 7 1 7 5 9 1 9 7 1 7 7 9 5 1 1 249 5 9 7 9 7 1 5 5 1 9 7 9 5 5 9 7 9 7 1 5 9 7 7 9 5 5 5 5 5 5 5 5 5 5 5 5 5 5 5 5 5 5 5 5 
5 5 5 5 5 5 5 5 5 5 5 5 5 5 5 5 9 1 1 7 5 9 7 7 1 5 5 9 1 9 7 9 1 9 1 9 1 7 9 5 7 7 1 5 9 249 7 9 7 1 7 1 5 41 42 5 5 7 1 9 7 7 9 5 7 7 7 7 1 5 1 7 1 7 9 5 1 7 9 7 5 5 5 5 5 5 5 5 5 5 5 5 5 5 5 5 5 5 5 5 
5 5 5 5 5 5 5 5 5 5 5 5 5 5 5 5 1 7 7 1 5 1 7 1 5 5 5 1 7 7 1 9 7 7 1 9 7 9 1 5 1 9 7 5 7 1 7 1 9 7 9 7 44 1 7 5 5 9 7 7 1 7 7 5 9 7 9 7 7 5 5 9 7 7 9 5 7 7 7 9 5 5 5 5 5 5 5 5 5 5 5 5 5 5 5 5 5 5 5 5 
5 5 5 5 5 5 5 5 5 5 5 5 5 5 5 5 9 7 9 5 9 7 7 9 5 5 5 7 1 7 9 1 7 7 9 5 5 5 5 5 5 5 5 5 5 5 5 5 5 7 7 1 45 7 1 5 5 1 7 9 7 7 7 1 5 1 7 7 9 5 5 1 7 9 7 9 1 9 7 7 1 5 5 5 5 5 5 5 5 5 5 5 5 5 5 5 5 5 5 5 
5 5 5 5 5 5 5 5 5 5 5 5 5 5 5 9 7 9 1 5 9 1 9 5 5 5 5 5 5 5 5 7 7 1 9 5 5 5 5 5 1 7 9 7 44 1 7 249 5 1 9 7 5 38 39 5 5 7 7 1 5 9 1 7 5 7 7 1 7 5 5 7 7 1 9 9 7 1 9 7 7 5 5 5 5 5 5 5 5 5 5 5 5 5 5 5 5 5 5 5 
5 5 5 5 5 5 5 5 5 5 5 5 5 5 5 7 9 7 9 5 7 7 1 5 5 5 5 5 5 1 7 1 9 7 5 5 5 5 5 5 9 7 1 7 45 9 9 1 5 7 9 1 5 9 9 5 9 9 7 7 5 7 7 9 5 1 7 7 9 5 9 1 9 7 1 7 1 9 7 7 9 5 5 5 5 5 5 5 5 5 5 5 5 5 5 5 5 5 5 5 
5 5 5 5 5 5 5 5 5 5 5 5 5 5 9 9 9 1 5 5 1 7 5 5 7 1 7 7 9 9 9 7 1 5 5 5 5 5 5 5 7 9 7 9 5 5 5 5 5 38 37 39 5 1 9 5 7 7 7 9 5 9 7 7 5 7 9 7 7 5 7 9 7 7 7 5 9 7 9 7 7 7 5 5 5 5 5 5 5 5 5 5 5 5 5 5 5 5 5 5 
5 5 5 5 5 5 5 5 5 5 5 5 5 5 7 1 7 9 5 1 9 7 5 9 1 7 9 9 1 7 1 9 7 5 5 1 9 7 9 5 1 9 1 7 44 1 9 249 5 1 9 7 5 9 1 5 9 7 9 7 5 7 9 9 5 1 7 9 7 5 7 7 7 7 1 5 5 7 1 7 7 7 1 5 5 5 5 5 5 5 5 5 5 5 5 5 5 5 5 5 
5 5 5 5 5 5 5 5 5 5 5 5 5 5 9 7 7 1 5 9 7 9 5 7 391 9 1 7 9 9 7 9 5 5 5 9 249 9 7 5 9 249 7 1 45 9 7 1 5 9 7 9 5 9 249 5 7 9 7 5 5 9 1 7 5 7 7 7 5 5 1 9 7 7 9 5 5 7 7 7 9 7 7 5 5 5 5 5 5 5 5 5 5 5 5 5 5 5 5 5 
5 5 5 5 5 5 5 5 5 5 5 5 5 5 9 7 9 5 5 9 9 5 5 9 7 7 7 9 1 5 5 5 5 5 1 9 7 1 7 5 7 1 9 9 5 5 5 5 5 7 7 1 5 5 5 5 7 9 9 5 9 7 7 9 5 7 9 7 5 5 7 7 1 9 7 5 5 7 9 1 7 7 7 5 5 5 5 5 5 5 5 5 5 5 5 5 5 5 5 5 
5 5 5 5 5 5 5 5 5 5 5 5 5 5 7 9 7 5 5 7 7 5 5 5 5 5 5 5 5 5 5 5 5 5 7 7 1 9 7 5 5 7 9 1 44 9 1 249 5 1 9 7 5 5 9 1 9 7 5 5 7 7 9 7 5 7 391 1 5 7 9 9 391 7 7 5 5 9 7 9 7 7 9 5 5 5 5 5 5 5 5 5 5 5 5 5 5 5 5 5 
5 5 5 5 5 5 5 5 5 5 5 5 5 1 9 9 9 5 7 9 1 5 5 5 9 1 9 7 1 9 5 5 5 5 9 7 7 7 9 5 5 9 7 7 45 1 9 7 5 9 249 9 5 5 7 9 7 1 5 1 9 7 7 1 5 7 9 7 5 9 7 7 9 7 9 5 5 1 9 7 9 7 1 5 5 5 5 5 5 5 5 5 5 5 5 5 5 5 5 5 
5 5 5 5 5 5 5 5 5 5 5 5 5 9 7 7 9 5 9 7 7 1 9 1 9 7 1 9 7 9 1 9 5 5 7 1 9 7 1 7 5 7 7 9 5 5 5 5 5 7 1 9 5 5 1 7 7 9 5 7 7 7 1 7 5 5 5 5 5 5 5 5 5 5 5 5 5 7 7 9 7 9 7 9 5 5 5 5 5 5 5 5 5 5 5 5 5 5 5 5 
5 5 5 5 5 5 5 5 5 5 5 5 5 7 9 1 7 5 1 7 7 9 7 9 7 7 7 9 7 9 7 1 1 5 1 7 1 7 7 9 5 1 9 7 44 9 249 5 5 5 5 5 5 9 7 7 9 5 5 9 7 9 7 9 5 9 7 1 5 9 7 1 7 9 7 9 5 7 7 7 7 7 9 7 5 5 5 5 5 5 5 5 5 5 5 5 5 5 5 5 
5 5 5 5 5 5 5 5 5 5 5 5 5 1 7 7 9 5 9 9 1 9 1 7 9 1 9 1 1 7 7 9 7 5 5 1 9 7 7 7 5 7 1 9 45 1 5 9 9 1 7 9 1 7 9 1 7 5 9 7 7 9 1 5 5 9 249 7 5 9 7 9 7 7 7 1 5 1 7 7 9 1 7 7 5 5 5 5 5 5 5 5 5 5 5 5 5 5 5 5 
5 5 5 5 5 5 5 5 5 5 5 5 5 7 7 9 9 5 1 7 9 7 9 7 9 7 5 9 7 7 1 9 1 5 5 9 7 9 7 1 5 5 9 7 5 5 9 7 1 7 9 1 7 9 1 7 9 5 7 1 1 7 7 5 1 7 9 1 5 1 7 7 7 7 7 9 5 9 7 9 7 391 7 7 5 5 5 5 5 5 5 5 5 5 5 5 5 5 5 5 
5 5 5 5 5 5 5 5 5 5 5 5 5 9 7 1 7 5 5 5 5 9 1 7 1 9 5 1 7 1 9 7 7 5 5 7 9 7 1 7 9 5 5 5 5 9 1 9 5 5 5 5 5 9 7 1 5 5 9 7 7 9 5 5 7 7 1 7 5 7 9 7 7 7 1 9 7 5 9 7 1 9 7 7 5 5 5 5 5 5 5 5 5 5 5 5 5 5 5 5 
5 5 5 5 5 5 5 5 5 5 5 5 5 5 9 9 7 9 7 9 5 5 9 9 7 1 5 9 1 7 7 7 7 9 5 9 7 1 7 9 1 5 1 9 1 7 9 5 5 9 7 1 5 5 1 5 5 7 1 7 9 7 5 1 9 7 7 9 5 9 7 1 9 5 7 9 1 5 5 5 5 5 5 5 5 5 5 5 5 5 5 5 5 5 5 5 5 5 5 5 
5 5 5 5 5 5 5 5 5 5 5 5 5 5 1 7 9 7 9 7 7 9 5 9 9 7 5 5 7 1 9 7 9 7 5 5 1 7 7 1 7 5 5 7 9 1 9 5 7 1 9 9 1 5 5 5 1 7 7 1 7 1 5 7 1 7 7 1 5 7 7 7 1 5 1 7 7 9 1 7 9 9 1 7 1 9 5 5 5 5 5 5 5 5 5 5 5 5 5 5 
5 5 5 5 5 5 5 5 5 5 5 5 5 5 7 7 9 1 9 9 7 1 5 5 7 9 1 5 9 7 1 7 7 9 9 5 5 9 1 7 7 1 5 5 9 9 1 5 1 9 1 9 249 5 5 7 7 7 1 7 9 5 7 1 7 7 1 5 5 7 1 7 5 5 7 7 9 7 7 1 7 9 7 1 391 1 5 5 5 5 5 5 5 5 5 5 5 5 5 5 
5 5 5 5 5 5 5 5 5 5 5 5 5 5 1 7 7 9 5 7 7 7 7 5 9 7 9 5 7 9 9 9 7 1 9 5 5 5 7 9 7 7 9 5 1 9 1 5 9 1 9 9 1 5 9 7 7 9 7 9 5 7 7 7 7 1 7 5 9 7 9 1 5 5 1 1 7 1 7 7 1 7 7 9 1 7 5 5 5 5 5 5 5 5 5 5 5 5 5 5 
5 5 5 5 5 5 5 5 5 5 5 5 5 5 7 9 7 7 9 5 1 7 9 5 1 7 7 5 1 9 7 9 9 7 7 9 5 5 5 7 9 1 7 5 9 9 23 5 5 9 1 1 5 5 7 7 9 7 1 5 5 7 1 7 9 7 1 5 7 1 7 7 5 5 7 7 9 5 5 5 5 5 5 7 1 7 9 5 5 5 5 5 5 5 5 5 5 5 5 5 
5 5 5 5 5 5 5 5 5 5 5 5 5 5 9 1 9 7 1 5 9 7 7 5 7 7 9 5 5 9 1 9 7 9 9 9 1 5 5 5 9 7 9 1 5 1 9 1 5 5 9 5 5 7 9 7 7 9 5 5 7 9 7 7 1 9 5 5 7 9 7 7 5 5 7 7 1 5 9 7 9 5 5 9 9 7 7 5 5 5 5 5 5 5 5 5 5 5 5 5 
5 5 5 5 5 5 5 5 5 5 5 5 5 5 5 7 7 1 7 5 1 9 9 5 1 9 1 1 5 1 7 7 9 9 7 7 9 9 5 5 5 1 7 7 9 5 9 391 5 9 9 1 5 391 7 1 5 5 5 9 1 9 7 1 7 5 5 9 1 7 9 1 5 5 7 9 7 5 7 249 1 5 5 5 7 1 9 5 5 5 5 5 5 5 5 5 5 5 5 5 
5 5 5 5 5 5 5 5 5 5 5 5 5 5 5 1 7 7 1 5 9 7 1 5 9 7 7 7 5 5 5 5 5 5 9 1 9 7 9 5 5 9 7 9 7 5 1 9 5 1 249 9 5 9 7 5 5 9 7 1 7 7 7 9 5 5 9 7 7 9 7 5 5 5 1 7 9 5 9 9 7 5 1 5 9 7 1 5 5 5 5 5 5 5 5 5 5 5 5 5 
5 5 5 5 5 5 5 5 5 5 5 5 5 5 5 9 7 1 9 5 1 9 1 5 5 1 7 7 9 1 9 7 9 5 9 7 9 7 1 5 5 9 1 7 9 5 5 5 5 5 5 5 5 5 5 5 9 7 1 7 7 1 9 5 5 1 7 7 1 7 1 5 5 1 7 9 1 5 1 7 1 5 9 5 7 9 9 5 5 5 5 5 5 5 5 5 5 5 5 5 
5 5 5 5 5 5 5 5 5 5 5 5 5 5 5 7 7 7 7 5 5 7 1 5 5 9 1 9 7 7 1 9 7 5 1 9 7 7 9 7 5 7 7 7 7 1 5 5 5 5 5 5 5 5 1 9 7 9 1 7 9 7 5 5 1 7 7 9 7 5 5 5 7 9 7 9 5 5 9 9 7 5 1 5 9 1 7 5 5 5 5 5 5 5 5 5 5 5 5 5 
5 5 5 5 5 5 5 5 5 5 5 5 5 5 5 1 7 9 9 7 5 1 9 9 1 5 9 7 9 1 9 7 9 5 5 7 9 7 7 9 5 5 7 9 7 7 7 7 9 7 1 9 7 1 7 7 1 7 9 7 1 5 5 1 7 9 1 7 5 5 5 1 9 7 9 7 5 5 7 1 9 5 9 5 5 7 9 7 5 5 5 5 5 5 5 5 5 5 5 5 
5 5 5 5 5 5 5 5 5 5 5 5 5 5 5 9 7 7 1 7 5 7 7 7 9 5 5 5 5 9 7 9 1 5 5 1 9 1 7 9 5 5 9 1 7 7 1 7 9 9 7 7 9 7 7 9 7 1 9 5 5 5 9 7 7 9 7 5 5 1 7 7 9 7 7 1 5 1 9 7 1 5 5 5 5 9 9 1 5 5 5 5 5 5 5 5 5 5 5 5 
5 5 5 5 5 5 5 5 5 5 5 5 5 5 5 5 1 7 9 7 5 1 9 1 9 7 9 1 9 5 9 1 7 5 5 5 5 9 9 1 5 5 7 7 9 7 7 7 7 7 1 7 7 7 1 7 9 9 5 5 7 1 7 1 7 7 7 5 9 7 9 1 7 7 9 5 9 7 1 9 5 5 7 5 5 7 7 9 5 5 5 5 5 5 5 5 5 5 5 5 
5 5 5 5 5 5 5 5 5 5 5 5 5 5 5 5 7 7 7 9 5 9 7 9 7 9 7 9 9 1 9 7 9 9 7 9 5 9 1 7 5 5 1 7 1 7 9 1 1 7 9 7 1 9 7 9 5 5 9 7 9 9 7 7 9 5 5 5 7 7 7 9 5 5 5 9 1 9 9 7 5 5 7 1 5 1 9 7 5 5 5 5 5 5 5 5 5 5 5 5 
5 5 5 5 5 5 5 5 5 5 5 5 5 5 5 5 9 1 9 7 5 1 9 9 1 9 1 9 7 7 9 9 9 7 7 7 9 7 9 9 5 5 5 5 5 5 5 5 5 5 5 5 5 5 5 5 5 7 1 7 7 7 1 5 5 5 5 9 9 1 9 5 5 1 9 7 9 7 9 1 5 9 1 7 5 7 1 9 5 5 5 5 5 5 5 5 5 5 5 5 
5 5 5 5 5 5 5 5 5 5 5 5 5 5 5 5 1 7 7 7 5 1 1 1 9 7 9 7 9 9 7 7 1 9 1 9 7 9 1 9 7 9 1 9 7 5 5 7 7 9 7 9 7 1 9 7 9 7 7 9 1 5 5 5 5 9 9 1 7 7 7 5 9 7 7 1 7 9 1 5 9 7 7 7 5 9 7 1 5 5 5 5 5 5 5 5 5 5 5 5 
5 5 5 5 5 5 5 5 5 5 5 5 5 5 5 5 7 9 7 9 5 5 5 5 5 5 5 5 5 9 9 7 1 7 7 7 9 9 7 1 9 1 7 249 7 5 9 9 9 9 7 7 1 9 7 1 7 7 1 7 5 5 9 7 9 1 7 7 7 9 5 5 7 1 9 9 7 7 5 9 1 7 9 1 5 9 7 9 5 5 5 5 5 5 5 5 5 5 5 5 
5 5 5 5 5 5 5 5 5 5 5 5 5 5 5 5 9 1 9 5 5 1 7 9 1 7 9 5 5 5 5 9 1 1 7 1 9 9 1 9 7 9 7 9 1 5 7 9 7 7 7 1 7 7 9 7 1 9 5 5 5 9 1 9 7 9 7 9 5 5 9 9 7 9 7 9 7 9 1 7 7 9 7 5 5 1 9 7 5 5 5 5 5 5 5 5 5 5 5 5 
5 5 5 5 5 5 5 5 5 5 5 5 5 5 5 5 7 391 7 5 9 7 9 7 7 7 7 7 9 1 5 5 5 5 5 5 5 5 5 5 5 5 5 5 5 5 9 7 9 1 9 9 7 7 1 9 5 5 5 9 9 1 7 9 9 1 5 5 5 7 9 7 9 7 9 1 7 1 7 9 7 1 9 5 9 7 1 9 5 5 5 5 5 5 5 5 5 5 5 5 
5 5 5 5 5 5 5 5 5 5 5 5 5 5 5 5 9 7 5 5 7 9 7 1 9 7 1 7 1 7 7 9 5 7 7 9 7 9 7 9 1 9 7 9 1 5 1 9 7 9 5 5 5 5 5 5 5 5 9 7 7 7 9 7 1 5 9 7 7 9 7 9 7 9 5 5 1 7 7 7 7 7 5 5 1 9 7 1 5 5 5 5 5 5 5 5 5 5 5 5 
5 5 5 5 5 5 5 5 5 5 5 5 5 5 5 5 5 5 5 1 7 7 9 9 5 5 7 9 7 9 1 7 9 7 1 7 9 7 7 7 7 7 7 7 7 5 7 9 7 5 5 1 9 7 1 9 5 1 9 1 7 9 1 9 5 7 9 7 7 7 7 1 5 5 5 9 7 9 9 7 9 5 1 9 7 7 1 5 5 5 5 5 5 5 5 5 5 5 5 5 
5 5 5 5 5 5 5 5 5 5 5 5 5 5 5 5 5 5 1 9 7 7 7 5 5 5 5 1 7 7 7 7 7 7 9 7 7 1 9 7 9 7 1 7 1 5 9 7 1 9 7 9 7 7 9 391 5 391 9 7 9 5 5 5 1 7 7 1 9 7 7 5 5 5 7 9 9 1 5 5 5 1 9 7 1 9 9 5 5 5 5 5 5 5 5 5 5 5 5 5 
5 5 5 5 5 5 5 5 5 5 5 5 5 5 5 5 5 5 9 7 1 9 5 5 5 7 5 5 7 7 7 1 9 7 5 5 5 5 5 5 1 7 7 7 9 5 7 9 7 7 9 7 1 9 7 9 5 1 5 5 5 9 9 7 9 1 7 9 7 9 9 5 1 7 9 7 9 7 7 1 9 7 7 9 9 1 5 5 5 5 5 5 5 5 5 5 5 5 5 5 
5 5 5 5 5 5 5 5 5 5 5 5 5 5 5 5 5 5 7 7 7 7 5 5 5 9 7 5 5 5 7 7 7 9 5 7 7 9 7 9 7 9 7 7 7 5 9 1 7 7 9 7 9 5 5 5 5 5 9 7 1 7 1 9 7 1 7 9 5 5 5 5 7 9 7 7 1 7 9 7 9 9 1 9 7 9 5 5 5 5 5 5 5 5 5 5 5 5 5 5 
5 5 5 5 5 5 5 5 5 5 5 5 5 5 5 5 5 5 9 7 7 9 1 5 5 7 391 7 9 5 5 9 7 9 5 9 7 1 9 7 7 7 1 9 9 5 5 5 5 5 5 5 5 9 7 9 249 5 7 7 7 7 7 9 9 9 5 5 5 5 5 9 7 1 7 9 5 9 1 7 7 7 9 7 9 9 5 5 5 5 5 5 5 5 5 5 5 5 5 5 
5 5 5 5 5 5 5 5 5 5 5 5 5 5 5 5 5 5 5 1 9 7 7 9 5 7 9 7 7 7 5 5 5 5 5 1 7 7 9 1 7 9 7 1 7 5 9 7 1 9 7 9 7 9 7 9 9 5 7 1 9 7 9 1 9 5 9 7 9 1 5 9 7 9 5 5 5 9 7 7 9 7 7 9 5 5 5 5 5 5 5 5 5 5 5 5 5 5 5 5 
5 5 5 5 5 5 5 5 5 5 5 5 5 5 5 5 5 5 5 5 1 7 9 7 5 5 7 9 7 9 1 7 5 5 5 7 9 1 5 5 5 5 5 5 5 5 1 9 9 7 9 9 7 9 9 7 249 5 9 7 1 7 9 7 5 9 7 7 7 249 5 7 1 5 5 7 9 1 7 9 7 7 5 5 5 5 5 5 5 5 5 5 5 5 5 5 5 5 5 5 
5 5 5 5 5 5 5 5 5 5 5 5 5 5 5 5 5 5 5 5 7 9 7 1 9 5 5 5 1 7 7 7 9 7 7 9 7 9 5 5 5 5 5 5 5 5 7 1 7 9 9 7 9 9 7 9 5 5 7 9 7 9 5 5 1 7 1 7 9 7 5 5 5 5 1 9 7 9 9 1 9 9 5 5 5 5 5 5 5 5 5 5 5 5 5 5 5 5 5 5 
5 5 5 5 5 5 5 5 5 5 5 5 5 5 5 5 5 5 5 5 5 7 7 7 7 7 7 5 5 5 9 7 7 9 7 7 1 7 5 1 9 7 9 5 5 5 9 7 7 1 9 5 5 5 5 5 9 7 7 7 1 7 9 7 1 9 1 5 5 5 5 5 1 9 7 7 9 7 7 7 5 5 5 5 5 5 5 5 5 5 5 5 5 5 5 5 5 5 5 5 
5 5 5 5 5 5 5 5 5 5 5 5 5 5 5 5 5 5 5 5 5 5 5 1 9 7 7 7 9 5 5 5 9 7 9 9 7 1 5 391 7 9 7 9 1 9 7 9 1 9 7 1 9 7 9 7 7 1 9 7 9 9 7 9 5 5 5 5 9 9 7 9 7 9 9 9 1 9 5 5 5 5 5 5 5 5 5 5 5 5 5 5 5 5 5 5 5 5 5 5 
5 5 5 5 5 5 5 5 5 5 5 5 5 5 5 5 5 5 5 5 5 5 5 5 7 9 7 7 7 9 7 5 5 5 1 7 7 9 5 9 9 7 1 7 7 1 7 1 7 7 9 9 7 7 1 9 9 7 9 5 5 5 5 5 5 7 1 7 1 7 9 7 1 7 1 5 5 5 5 5 5 5 5 5 5 5 5 5 5 5 5 5 5 5 5 5 5 5 5 5 
5 5 5 5 5 5 5 5 5 5 5 5 5 5 5 5 5 5 5 5 5 5 5 5 5 5 1 7 1 7 7 7 9 5 5 5 5 5 5 5 5 1 9 9 9 7 9 7 9 9 7 9 7 7 7 7 1 5 5 5 9 7 9 1 7 9 7 7 7 1 7 7 9 9 5 5 5 5 5 5 5 5 5 5 5 5 5 5 5 5 5 5 5 5 5 5 5 5 5 5 
5 5 5 5 5 5 5 5 5 5 5 5 5 5 5 5 5 5 5 5 5 5 5 5 5 5 5 5 9 7 7 7 7 7 9 7 1 5 9 1 9 5 7 7 5 5 5 9 18 16 19 9 5 5 5 5 5 5 7 9 7 7 7 9 1 7 9 7 9 5 5 5 5 5 5 5 5 5 5 5 5 5 5 5 5 5 5 5 5 5 5 5 5 5 5 5 5 5 5 5 
5 5 5 5 5 5 5 5 5 5 5 5 5 5 5 5 5 5 5 5 5 5 5 5 5 5 5 5 5 1 7 9 7 9 7 9 391 5 249 7 1 9 7 9 7 1 5 9 14 6 13 7 5 9 1 7 7 9 7 7 7 1 9 5 5 5 5 5 5 5 5 5 5 5 5 5 5 5 5 5 5 5 5 5 5 5 5 5 5 5 5 5 5 5 5 5 5 5 5 5 
5 5 5 5 5 5 5 5 5 5 5 5 5 5 5 5 5 5 5 5 5 5 5 5 5 5 5 5 5 5 5 5 5 1 7 1 7 5 9 1 7 7 9 7 1 7 5 9 14 6 13 9 5 1 7 7 1 391 1 9 7 9 5 5 5 5 5 5 5 5 5 5 5 5 5 5 5 5 5 5 5 5 5 5 5 5 5 5 5 5 5 5 5 5 5 5 5 5 5 5 
5 5 5 5 5 5 5 5 5 5 5 5 5 5 5 5 5 5 5 5 5 5 5 5 5 5 5 5 5 5 5 5 5 5 5 5 5 5 5 5 1 7 9 1 7 9 5 5 114 115 116 5 5 9 7 1 7 1 9 1 5 5 5 5 5 5 5 5 5 5 5 5 5 5 5 5 5 5 5 5 5 5 5 5 5 5 5 5 5 5 5 5 5 5 5 5 5 5 5 5 
5 5 5 5 5 5 5 5 5 5 5 5 5 5 5 5 5 5 5 5 5 5 5 5 5 5 5 5 5 5 5 5 5 5 5 5 5 5 5 5 5 5 5 5 5 5 5 117 118 118 118 119 5 5 5 5 5 5 5 5 5 5 5 5 5 5 5 5 5 5 5 5 5 5 5 5 5 5 5 5 5 5 5 5 5 5 5 5 5 5 5 5 5 5 5 5 5 5 5 5 
5 5 5 5 5 5 5 5 5 5 5 5 5 5 5 5 5 5 5 5 5 5 5 5 5 5 5 5 5 5 5 5 5 5 5 5 5 5 5 5 5 5 5 5 5 5 5 120 121 121 121 122 5 5 5 5 5 5 5 5 5 5 5 5 5 5 5 5 5 5 5 5 5 5 5 5 5 5 5 5 5 5 5 5 5 5 5 5 5 5 5 5 5 5 5 5 5 5 5 5 
5 5 5 5 5 5 5 5 5 5 5 5 5 5 5 5 5 5 5 5 5 5 5 5 5 5 5 5 5 5 5 5 5 5 5 5 5 5 5 5 5 5 5 5 5 5 5 123 124 124 124 125 5 5 5 5 5 5 5 5 5 5 5 5 5 5 5 5 5 5 5 5 5 5 5 5 5 5 5 5 5 5 5 5 5 5 5 5 5 5 5 5 5 5 5 5 5 5 5 5 
5 5 5 5 5 5 5 5 5 5 5 5 5 5 5 5 5 5 5 5 5 5 5 5 5 5 5 5 5 5 5 5 5 5 5 5 5 5 5 5 5 5 5 5 5 5 5 126 127 128 129 130 5 5 5 5 5 5 5 5 5 5 5 5 5 5 5 5 5 5 5 5 5 5 5 5 5 5 5 5 5 5 5 5 5 5 5 5 5 5 5 5 5 5 5 5 5 5 5 5 
5 5 5 5 5 5 5 5 5 5 5 5 5 5 5 5 5 5 5 5 5 5 5 5 5 5 5 5 5 5 5 5 5 5 5 5 5 5 5 5 5 5 5 5 5 5 5 131 132 133 134 135 5 5 5 5 5 5 5 5 5 5 5 5 5 5 5 5 5 5 5 5 5 5 5 5 5 5 5 5 5 5 5 5 5 5 5 5 5 5 5 5 5 5 5 5 5 5 5 5 
5 5 5 5 5 5 5 5 5 5 5 5 5 5 5 5 5 5 5 5 5 5 5 5 5 5 5 5 5 5 5 5 5 5 5 5 5 5 5 5 5 5 5 5 5 5 5 1 136 137 138 9 5 5 5 5 5 5 5 5 5 5 5 5 5 5 5 5 5 5 5 5 5 5 5 5 5 5 5 5 5 5 5 5 5 5 5 5 5 5 5 5 5 5 5 5 5 5 5 5 
5 5 5 5 5 5 5 5 5 5 5 5 5 5 5 5 5 5 5 5 5 5 5 5 5 5 5 5 5 5 5 5 5 5 5 5 5 5 5 5 5 5 5 5 5 5 5 9 14 6 13 1 5 5 5 5 5 5 5 5 5 5 5 5 5 5 5 5 5 5 5 5 5 5 5 5 5 5 5 5 5 5 5 5 5 5 5 5 5 5 5 5 5 5 5 5 5 5 5 5 
