251 251 251 251 251 251 251 251 251 251 251 251 251 251 251 251 251 251 251 251 251 251 251 251 251 251 251 250 250 250 251 251 251 251 251 251 251 251 251 251 251 251 251 251 251 251 251 251 251 251 251 251 251 251 251 251 251 251 251 251 251 251 251 251 251 251 251 251 251 251 251 251 251 251 251 251 251 251 251 251 251 251 251 251 251 251 251 251 251 251 251 251 251 251 251 251 251 251 251 251 
251 251 251 251 251 251 251 251 251 251 251 251 251 251 251 251 251 251 251 251 251 251 251 251 251 251 251 250 250 250 251 251 251 251 251 251 251 251 251 251 251 251 251 251 251 251 251 251 251 251 251 251 251 251 251 251 251 251 251 251 251 251 251 251 251 251 251 251 251 251 251 251 251 251 251 251 251 251 251 251 251 251 251 251 251 251 251 251 251 251 251 251 251 251 251 251 251 251 251 251 
251 251 251 251 251 251 251 251 251 251 251 251 251 251 251 251 251 251 251 251 251 251 251 251 251 251 251 250 250 250 251 251 251 251 251 251 251 251 251 251 251 251 251 251 251 251 251 251 251 251 251 251 251 251 251 251 251 251 251 251 251 251 251 251 251 251 251 251 251 251 251 251 251 251 251 251 251 251 251 251 251 251 251 251 251 251 251 251 251 251 251 251 251 251 251 251 251 251 251 251 
251 251 251 251 251 251 251 251 251 251 251 251 251 251 251 251 251 251 251 251 251 251 251 251 251 251 251 250 250 250 251 251 251 251 251 251 251 251 251 251 251 251 251 251 251 251 251 251 251 251 251 251 251 251 251 251 251 251 251 251 251 251 251 251 251 251 251 251 251 251 251 251 251 251 251 251 251 251 251 251 251 251 251 251 251 251 251 251 251 251 251 251 251 251 251 251 251 251 251 251 
251 251 251 251 251 251 251 251 251 251 251 251 251 251 251 251 251 251 251 251 251 251 251 251 251 251 251 250 250 250 251 251 251 251 251 251 251 251 251 251 251 251 251 251 251 251 251 251 251 251 251 251 251 251 251 251 251 251 251 251 250 251 251 251 251 251 251 251 251 251 251 251 251 251 251 251 251 251 251 251 251 251 251 251 251 251 251 251 251 251 251 251 251 251 251 251 251 251 251 251 
251 251 251 251 251 251 251 251 251 251 251 251 251 251 251 251 251 251 251 251 251 251 251 251 251 251 251 250 250 250 251 251 251 251 251 251 251 251 251 251 251 251 251 251 251 251 251 251 251 251 251 251 251 251 251 251 251 251 251 251 250 251 251 251 251 251 251 251 251 251 251 251 251 251 251 251 251 251 251 251 251 251 251 251 251 251 251 251 251 251 251 251 251 251 251 251 251 251 251 251 
251 251 251 251 251 251 251 251 251 251 251 251 251 251 251 251 251 251 251 251 251 251 251 251 251 251 251 250 250 250 251 251 251 251 251 251 251 251 251 251 251 251 251 251 251 251 251 251 251 251 251 251 251 251 251 251 251 251 251 251 250 251 251 251 251 251 251 251 251 251 251 251 251 251 251 251 251 251 251 251 251 251 251 251 251 251 251 251 251 251 251 251 251 251 251 251 251 251 251 251 
258 258 258 258 258 258 258 258 258 258 258 258 258 258 258 258 258 258 258 258 258 258 258 258 258 258 261 250 250 263 258 258 258 258 261 251 251 251 251 251 251 251 251 251 251 251 251 251 251 251 251 251 251 251 251 251 251 251 251 251 250 251 251 251 251 251 251 251 251 251 251 251 251 251 251 251 251 251 251 251 251 251 251 251 251 251 251 251 251 251 251 251 251 251 251 251 251 251 251 251 
258 258 258 258 258 258 258 258 258 258 258 258 258 258 258 258 258 258 258 258 258 258 258 258 258 261 250 250 263 258 258 258 258 261 250 251 251 251 251 251 251 251 251 251 251 251 251 251 251 251 251 251 251 251 251 251 251 251 251 251 250 251 251 251 251 251 251 251 251 251 251 251 251 251 251 251 251 251 251 251 251 251 251 251 251 251 251 251 251 251 251 251 251 251 251 251 251 251 251 251 
258 258 258 258 258 258 258 261 5 5 5 5 250 5 5 5 5 249 5 5 249 5 5 5 249 250 250 253 261 251 251 251 251 250 250 251 251 251 251 251 251 251 251 251 251 251 251 251 251 251 251 251 251 251 251 251 251 251 251 251 250 251 251 251 251 251 251 251 251 251 251 251 251 251 251 251 251 251 251 251 251 251 251 251 251 251 251 251 251 251 251 251 251 251 251 251 251 251 251 251 
258 258 258 258 258 258 261 250 5 5 1 5 250 5 5 5 1 9 1 9 1 5 5 249 5 250 250 5 250 251 251 251 251 250 250 251 251 251 251 251 251 251 251 251 251 251 251 251 251 251 251 251 251 251 251 251 251 251 251 251 250 251 251 251 251 251 251 251 251 251 251 251 251 251 251 251 251 251 251 251 251 251 251 251 251 251 251 251 251 251 251 251 251 251 251 251 251 251 251 251 
5 5 5 5 5 5 250 250 5 1 5 1 250 5 5 1 9 18 16 16 16 16 19 5 5 250 250 5 253 261 251 251 251 250 250 251 251 251 251 251 251 251 251 251 251 251 251 251 251 251 251 251 251 251 251 251 251 251 251 251 250 251 251 251 251 251 251 251 251 251 251 251 251 251 251 251 251 251 251 251 251 251 251 251 251 251 251 251 251 251 251 251 251 251 251 251 251 251 251 251 
5 5 5 5 5 5 250 250 5 5 1 5 250 249 5 9 18 17 6 6 6 6 13 1 249 250 250 5 5 250 251 251 251 250 250 251 251 251 251 251 251 251 251 251 251 251 251 251 251 251 251 251 251 251 251 251 251 251 251 251 250 251 251 251 251 251 251 251 251 251 251 251 251 251 251 251 251 251 251 251 251 251 251 251 251 251 251 251 251 251 251 251 251 251 251 251 251 251 251 251 
5 5 5 5 5 5 250 250 5 5 5 5 250 5 9 1 14 6 6 10 12 6 15 19 5 250 250 5 5 250 251 251 251 250 250 251 251 251 251 251 251 251 251 251 251 251 251 251 251 251 251 251 251 251 251 251 251 251 251 251 250 251 251 251 251 251 251 251 251 251 251 251 251 251 251 251 251 251 251 251 251 251 251 251 251 251 251 251 251 251 251 251 251 251 251 251 251 251 251 251 
5 5 5 5 5 5 250 250 5 1 5 249 250 5 5 1 20 11 11 21 14 6 6 13 9 250 250 5 249 253 258 258 261 250 263 258 258 258 258 258 258 261 251 251 251 251 251 251 251 251 251 251 251 251 251 251 251 251 251 251 250 251 251 251 251 251 251 251 251 251 251 251 251 251 251 251 251 251 251 251 251 251 251 251 251 251 251 251 251 251 251 251 251 251 251 251 251 251 251 251 
5 5 5 5 5 5 250 250 5 5 5 1 253 258 258 258 254 255 258 261 20 12 6 13 1 250 250 5 5 5 249 5 250 253 258 258 261 5 5 9 9 250 251 251 251 251 251 251 251 251 251 251 251 251 251 251 251 251 251 251 250 251 251 251 251 251 251 251 251 251 251 251 251 251 251 251 251 251 251 251 251 251 251 251 251 251 251 251 251 251 251 251 251 251 251 251 251 251 251 251 
5 5 5 5 5 5 250 250 5 249 5 1 9 5 5 14 6 6 13 250 5 14 6 13 1 250 250 5 5 249 1 5 250 9 9 1 250 5 9 1 9 250 251 251 251 251 251 251 251 251 251 251 251 251 251 251 251 251 251 251 250 251 251 251 251 251 251 251 251 251 251 251 251 251 251 251 251 251 251 251 251 251 251 251 251 251 251 251 251 251 251 251 251 251 251 251 251 251 251 251 
5 5 5 5 5 5 250 250 5 5 5 1 9 9 18 17 6 10 21 250 1 14 6 15 19 250 250 249 1 9 249 249 250 9 1 9 250 1 9 9 9 250 251 251 251 251 251 251 251 251 251 251 251 251 251 251 251 251 251 251 250 251 251 251 251 251 251 251 251 251 251 251 251 251 251 251 251 251 251 251 251 251 251 251 251 251 251 251 251 251 251 251 251 251 251 251 251 251 251 251 
5 5 5 5 5 5 250 250 5 5 5 5 5 1 14 6 6 13 5 250 9 14 6 6 13 250 250 5 1 249 5 5 250 1 9 1 374 9 9 9 1 250 251 251 251 251 251 251 251 251 251 251 251 251 251 251 251 251 251 251 250 251 251 251 251 251 251 251 251 251 251 251 251 251 251 251 251 251 251 251 251 251 251 251 251 251 251 251 251 251 251 251 251 251 251 251 251 251 251 251 
5 5 5 5 5 5 250 250 5 1 5 249 5 5 14 6 10 21 1 250 1 20 12 6 13 250 250 249 9 1 1 5 250 1 9 9 250 9 1 9 9 253 258 258 258 258 258 258 258 258 258 261 251 251 251 251 251 251 251 251 250 251 251 251 251 251 251 251 251 251 251 251 251 251 251 251 251 251 251 251 251 251 251 251 251 251 251 251 251 251 251 251 251 251 251 251 251 251 251 251 
5 5 5 5 5 5 250 250 5 5 5 9 5 18 17 6 13 9 9 250 5 5 14 6 13 250 250 5 5 1 9 5 250 9 9 9 250 9 9 9 1 9 9 9 9 9 5 9 1 9 9 253 258 258 261 251 251 251 251 251 250 251 251 251 251 251 251 251 251 251 251 251 251 251 251 251 251 251 251 251 251 251 251 251 251 251 251 251 251 251 251 251 251 251 251 251 251 251 251 251 
5 5 5 5 5 5 250 250 5 5 9 1 5 14 6 6 13 9 5 250 414 5 14 6 13 250 250 5 9 9 1 5 250 41 40 42 250 5 5 9 9 1 9 9 1 9 9 9 9 1 9 9 9 9 253 258 258 258 258 261 250 251 251 251 251 251 251 251 251 251 251 251 251 251 251 251 251 251 251 251 251 251 251 251 251 251 251 251 251 251 251 251 251 251 251 251 251 251 251 251 
5 5 5 5 5 5 250 250 5 5 1 9 9 14 6 10 21 5 5 250 413 1 14 6 13 250 250 5 1 9 9 5 250 9 9 1 250 5 5 5 1 9 9 9 9 9 9 1 9 9 1 9 1 1 9 9 9 9 5 250 250 251 251 251 251 251 251 251 251 251 251 251 251 251 251 251 251 251 251 251 251 251 251 251 251 251 251 251 251 251 251 251 251 251 251 251 251 251 251 251 
5 5 5 5 5 5 250 250 5 5 5 9 1 14 6 13 1 5 1 250 9 18 17 6 13 250 250 9 9 1 9 9 374 1 9 9 253 258 258 258 258 258 258 258 258 258 258 258 258 258 258 258 261 9 9 9 9 1 9 250 250 251 251 251 251 251 251 251 251 251 251 251 251 251 251 251 251 251 251 251 251 251 251 251 251 251 251 251 251 251 251 251 251 251 251 251 251 251 251 251 
5 5 5 5 5 5 250 250 1 5 5 1 18 17 6 13 5 5 9 250 1 14 6 6 13 374 374 9 9 9 1 5 250 9 9 1 9 43 9 9 1 9 9 9 1 9 9 9 1 9 9 5 250 9 9 1 9 5 1 250 250 251 251 251 251 251 251 251 251 251 251 251 251 251 251 251 251 251 251 251 251 251 251 251 251 251 251 251 251 251 251 251 251 251 251 251 251 251 251 251 
5 5 5 5 5 5 250 250 5 1 5 9 14 6 6 13 5 1 5 250 5 14 6 10 21 250 250 249 5 249 249 5 253 258 258 258 258 258 258 258 258 258 258 258 258 261 5 9 9 1 9 5 250 1 9 9 9 9 9 250 250 251 251 251 251 251 251 251 251 251 251 251 251 251 251 251 251 251 251 251 251 251 251 251 251 251 251 251 251 251 251 251 251 251 251 251 251 251 251 251 
5 5 5 5 5 5 250 250 5 5 9 18 17 6 10 21 9 5 5 250 5 14 6 13 5 250 250 9 9 9 1 9 9 44 1 9 9 9 1 9 9 9 9 5 5 250 5 9 9 9 9 1 250 9 5 9 9 1 5 250 250 251 251 251 251 251 251 251 251 251 251 251 251 251 251 251 251 251 251 251 251 251 251 251 251 251 251 251 251 251 251 251 251 251 251 251 251 251 251 251 
5 5 5 5 5 5 250 250 5 9 18 17 6 6 13 5 5 5 1 250 5 14 6 13 414 250 263 373 258 258 258 261 9 45 9 9 9 9 9 9 9 9 1 9 5 250 1 9 1 9 5 5 250 7 7 7 7 7 7 250 250 251 251 251 251 251 251 251 251 251 251 251 251 251 251 251 251 251 251 251 251 251 251 251 251 251 251 251 251 251 251 251 251 251 251 251 251 251 251 251 
5 5 5 5 5 5 250 250 5 1 60 6 6 10 21 1 5 1 5 250 5 14 6 13 413 253 258 373 258 258 261 263 258 261 9 1 9 9 1 9 9 1 9 9 9 250 7 7 7 7 7 7 250 7 7 7 7 7 7 250 250 251 251 251 251 251 251 251 251 251 251 251 251 251 251 251 251 251 251 251 251 251 251 251 251 251 251 251 251 251 251 251 251 251 251 251 251 251 251 251 
5 5 5 5 5 5 250 250 5 9 20 11 11 21 5 5 5 5 5 250 249 20 11 21 9 9 1 9 7 7 253 258 261 263 258 258 258 258 261 7 7 7 7 7 7 250 7 7 7 7 7 7 250 7 7 7 7 7 249 250 250 251 251 251 251 251 251 251 251 251 251 251 251 251 251 251 251 251 251 251 251 251 251 251 251 251 251 251 251 251 251 251 251 251 251 251 251 251 251 251 
5 5 5 5 5 5 250 250 5 5 5 5 5 5 249 5 1 9 1 250 5 5 5 5 1 249 7 7 7 7 7 7 253 258 258 258 258 261 250 7 7 7 7 7 7 250 7 7 7 7 7 7 250 7 7 7 7 7 7 250 250 251 251 251 251 251 251 251 251 251 251 251 251 251 251 251 251 251 251 251 251 251 251 251 251 251 251 251 251 251 251 251 251 251 251 251 251 251 251 251 
5 5 5 5 5 5 250 250 5 5 5 5 5 5 5 5 5 5 5 253 258 258 258 258 258 258 258 258 258 254 255 258 258 258 261 251 251 250 250 7 7 7 7 7 249 250 7 249 7 7 7 7 250 7 249 7 7 7 7 250 250 251 251 251 251 251 251 251 251 251 251 251 251 251 251 251 251 251 251 251 251 251 251 251 251 251 251 251 251 251 251 251 251 251 251 251 251 251 251 251 
5 5 5 5 5 5 250 263 258 258 258 258 258 258 258 258 258 258 258 258 258 258 258 258 258 258 258 258 258 254 255 258 261 251 250 251 251 250 250 7 7 7 7 7 7 250 7 7 7 7 7 7 250 7 7 7 7 7 7 250 250 251 251 251 251 251 251 251 251 251 251 251 251 251 251 251 251 251 251 251 251 251 251 251 251 251 251 251 251 251 251 251 251 251 251 251 251 251 251 251 
5 5 5 5 5 5 253 261 250 251 251 251 251 251 251 251 251 251 251 252 262 258 258 258 258 258 258 258 258 254 255 261 250 251 250 251 251 250 250 7 7 7 7 7 7 250 7 7 7 7 7 7 250 7 7 7 7 7 7 250 250 251 251 251 251 251 251 251 251 251 251 251 251 251 251 251 251 251 251 251 251 251 251 251 251 251 251 251 251 251 251 251 251 251 251 251 251 251 251 251 
5 5 5 5 5 5 5 250 250 251 251 251 251 251 251 251 251 251 262 264 252 5 5 5 5 5 5 5 5 9 9 250 250 251 250 251 251 250 250 7 7 7 249 7 7 250 7 7 7 7 7 7 250 7 7 7 249 7 7 250 250 251 251 251 251 251 251 251 251 251 251 251 251 251 251 251 251 251 251 251 251 251 251 251 251 251 251 251 251 251 251 251 251 251 251 251 251 251 251 251 
5 5 5 5 5 5 5 250 250 251 251 251 251 251 251 251 251 262 264 262 256 5 5 5 5 5 5 5 5 9 1 250 250 251 250 251 251 250 250 7 249 7 7 7 7 250 7 7 7 7 7 249 250 7 7 7 7 7 7 250 250 251 251 251 251 251 251 251 251 251 251 251 251 251 251 251 251 251 251 251 251 251 251 251 251 251 251 251 251 251 251 251 251 251 251 251 251 251 251 251 
5 5 5 5 5 5 5 250 263 261 251 251 251 251 251 262 258 264 262 256 5 5 270 257 271 5 5 9 9 1 9 250 250 251 250 251 251 250 250 7 7 7 7 7 7 250 7 7 7 7 7 7 250 7 7 7 7 7 249 250 250 251 251 251 251 251 251 251 251 251 251 251 251 251 251 251 251 251 251 251 251 251 251 251 251 251 251 251 251 251 251 251 251 251 251 251 251 251 251 251 
5 5 5 5 5 5 5 253 261 250 251 251 251 262 258 264 262 258 256 5 5 5 250 251 252 1 9 9 9 22 5 250 250 251 250 251 251 250 250 7 7 7 7 7 7 250 7 7 249 7 7 7 250 7 7 7 7 7 7 250 250 251 251 251 251 251 251 251 251 251 251 251 251 251 251 251 251 251 251 251 251 251 251 251 251 251 251 251 251 251 251 251 251 251 251 251 251 251 251 251 
5 5 5 5 5 5 5 5 250 250 251 262 258 264 251 251 252 5 5 5 5 9 253 258 256 9 1 9 9 9 5 250 250 251 250 251 251 250 250 7 7 7 249 7 7 250 7 7 7 7 7 7 250 5 5 1 5 5 5 250 250 251 251 251 251 251 251 251 251 251 251 251 251 251 251 251 251 251 251 251 251 251 251 251 251 251 251 251 251 251 251 251 251 251 251 251 251 251 251 251 
5 5 5 5 5 5 5 5 250 250 251 252 251 251 262 258 256 9 9 22 9 9 1 9 9 9 9 22 9 9 5 250 250 251 250 251 251 250 250 7 7 7 7 7 7 250 1 9 9 5 5 5 250 9 5 9 9 5 5 250 250 251 251 251 251 251 251 251 251 251 251 251 251 251 251 251 251 251 251 251 251 251 251 251 251 251 251 251 251 251 251 251 251 251 251 251 251 251 251 251 
5 5 5 5 5 5 5 5 250 253 258 256 262 258 256 5 1 9 9 9 1 9 9 9 9 270 257 257 271 9 1 250 250 251 250 251 251 250 250 5 9 1 9 5 5 250 9 9 9 9 9 1 250 1 5 9 1 5 5 250 250 251 251 251 251 251 251 251 251 251 251 251 251 251 251 251 251 251 251 251 251 251 251 251 251 251 251 251 251 251 251 251 251 251 251 251 251 251 251 251 
5 5 5 5 5 5 5 5 250 1 9 9 252 5 5 5 22 9 9 5 5 5 7 7 5 250 267 268 252 9 22 250 250 251 250 251 251 250 250 5 9 9 1 9 5 250 9 1 9 9 9 9 250 9 5 9 9 5 9 250 250 251 251 251 251 251 251 251 251 251 251 251 251 251 251 251 251 251 251 251 251 251 251 251 251 251 251 251 251 251 251 251 251 251 251 251 251 251 251 251 
5 5 5 5 5 5 5 5 250 9 9 1 252 9 9 9 9 1 5 5 7 7 7 7 5 250 250 252 252 9 9 250 250 251 250 251 251 250 250 9 1 9 9 9 5 250 5 9 9 9 9 5 250 9 5 9 5 5 9 250 250 251 251 251 251 251 251 251 251 251 251 251 251 251 251 251 251 251 251 251 251 251 251 251 251 251 251 251 251 251 251 251 251 251 251 251 251 251 251 251 
5 5 5 5 5 5 5 5 250 22 9 9 252 9 22 9 9 5 5 5 7 7 7 7 5 250 263 264 252 1 9 250 250 251 250 251 251 250 250 5 9 9 9 9 5 250 5 9 9 1 9 9 250 9 5 9 9 9 9 250 250 251 251 251 251 251 251 251 251 251 251 251 251 251 251 251 251 251 251 251 251 251 251 251 251 251 251 251 251 251 251 251 251 251 251 251 251 251 251 251 
5 5 5 5 5 5 5 5 253 258 254 258 256 5 5 5 5 5 5 5 5 9 1 9 5 253 258 258 256 9 9 250 250 251 250 251 251 250 250 5 9 9 9 5 5 250 5 9 9 9 9 9 250 9 9 9 9 9 1 250 250 251 251 251 251 251 251 251 251 251 251 251 251 251 251 251 251 251 251 251 251 251 251 251 251 251 251 251 251 251 251 251 251 251 251 251 251 251 251 251 
5 5 5 5 5 5 5 5 5 1 9 9 5 5 5 5 5 5 5 5 5 5 5 5 5 5 5 5 22 9 1 250 250 251 250 251 251 250 250 5 5 9 1 9 5 250 5 5 5 9 9 1 250 5 1 9 9 5 9 250 250 251 251 251 251 251 251 251 251 251 251 251 251 251 251 251 251 251 251 251 251 251 251 251 251 251 251 251 251 251 251 251 251 251 251 251 251 251 251 251 
5 5 5 5 5 5 5 5 5 5 9 9 1 5 5 5 5 5 5 5 5 5 5 9 1 9 9 9 9 9 5 250 250 251 250 251 251 250 250 5 5 5 9 9 5 250 5 5 5 5 9 9 250 5 9 9 1 9 9 250 250 251 251 251 251 251 251 251 251 251 251 251 251 251 251 251 251 251 251 251 251 251 251 251 251 251 251 251 251 251 251 251 251 251 251 251 251 251 251 251 
5 5 5 5 5 5 5 5 5 5 5 22 9 9 9 9 22 9 1 9 9 9 9 9 22 9 9 1 9 5 5 250 250 251 250 251 251 250 250 5 9 1 9 1 5 250 9 9 5 5 9 1 250 5 5 9 9 9 5 250 250 251 251 251 251 251 251 251 251 251 251 251 251 251 251 251 251 251 251 251 251 251 251 251 251 251 251 251 251 251 251 251 251 251 251 251 251 251 251 251 
5 5 5 5 5 5 5 5 5 5 5 5 5 5 1 9 9 9 9 9 9 1 9 5 5 5 5 5 5 5 5 250 250 251 250 251 251 250 250 9 9 9 9 9 5 250 9 1 9 5 5 9 250 5 5 9 9 5 5 250 253 258 258 258 258 258 258 258 258 258 258 258 258 258 261 251 251 251 251 251 251 251 251 251 251 251 251 251 251 251 251 251 251 251 251 251 251 251 251 251 
5 5 5 5 5 5 5 5 5 5 5 5 5 5 5 5 5 5 5 5 5 5 5 5 5 5 5 5 5 5 5 250 250 251 250 251 251 250 250 1 9 9 9 9 5 250 9 9 9 1 9 9 250 5 9 1 9 9 5 250 5 1 9 7 5 5 5 5 5 5 5 5 5 5 250 251 251 251 251 251 251 251 251 251 251 251 251 251 251 251 251 251 251 251 251 251 251 251 251 251 
5 5 5 5 5 5 5 5 5 5 5 5 5 5 5 5 5 5 5 5 5 5 5 5 5 5 5 5 5 5 5 250 250 251 250 251 251 250 250 9 9 1 9 9 5 250 9 9 9 9 9 5 250 5 9 9 1 9 9 374 9 9 9 1 7 7 7 7 7 7 5 5 5 5 250 251 251 251 251 251 251 251 251 251 251 251 251 251 251 251 251 251 251 251 251 251 251 251 251 251 
5 5 5 5 5 5 5 5 5 5 5 5 5 5 5 5 5 5 5 5 5 5 5 5 5 5 5 5 5 5 5 250 250 251 250 251 251 250 250 1 9 9 9 9 9 250 1 1 9 5 5 5 250 9 1 9 9 1 5 253 258 258 261 9 9 7 7 7 7 7 7 5 5 5 250 251 251 251 251 251 251 251 251 251 251 251 251 251 251 251 251 251 251 251 251 251 251 251 251 251 
5 5 5 5 5 5 5 5 5 5 5 5 5 5 5 5 5 5 5 5 5 5 5 5 5 5 5 5 5 5 5 250 250 251 250 251 251 250 250 9 9 1 9 1 9 250 9 9 9 9 5 5 250 5 5 5 5 5 5 5 7 7 253 258 258 261 7 7 7 7 7 7 7 5 250 251 251 251 251 251 251 251 251 251 251 251 251 251 251 251 251 251 251 251 251 251 251 251 251 251 
5 5 5 5 5 5 5 5 5 5 5 5 5 5 5 5 5 5 5 5 5 5 5 5 5 5 5 5 5 5 5 250 250 251 250 251 251 250 250 5 9 9 9 9 1 250 5 5 5 9 1 9 374 9 9 9 9 9 7 7 7 7 7 5 5 253 261 7 7 7 7 7 7 5 250 251 251 251 251 251 251 251 251 251 251 251 251 251 251 251 251 251 251 251 251 251 251 251 251 251 
5 5 5 5 5 5 5 5 5 5 5 5 5 5 5 5 5 5 5 5 5 5 5 5 5 5 5 5 5 5 5 250 250 251 250 251 251 250 250 5 9 9 9 9 9 250 5 5 5 5 5 5 250 9 9 9 9 7 7 7 7 7 7 7 5 5 253 261 7 7 7 7 9 1 250 251 251 251 251 251 251 251 251 251 251 251 251 251 251 251 251 251 251 251 251 251 251 251 251 251 
5 5 5 5 5 5 5 5 5 5 5 5 5 5 5 5 5 5 5 5 5 5 5 5 5 5 5 5 5 5 5 250 250 251 250 251 251 250 250 5 1 1 5 9 9 374 9 9 1 9 9 9 253 258 258 258 261 7 7 7 7 7 7 7 7 7 5 253 258 261 7 7 9 9 250 251 251 251 251 251 251 251 251 251 251 251 251 251 251 251 251 251 251 251 251 251 251 251 251 251 
5 5 5 5 5 5 5 5 5 5 5 5 257 257 257 257 257 257 257 257 257 257 257 257 257 257 257 257 257 257 257 257 257 257 257 257 257 257 257 257 257 257 257 257 257 250 5 5 5 5 5 9 9 5 5 5 253 261 5 7 7 7 7 7 7 7 7 9 9 253 261 9 1 9 250 251 251 251 251 251 251 251 251 251 251 251 251 251 251 251 251 251 251 251 251 251 251 251 251 251 
5 5 5 5 5 5 5 5 5 5 5 5 251 251 251 251 251 251 251 251 251 251 251 251 251 251 251 251 251 251 251 251 251 251 251 251 251 251 251 251 251 251 251 251 251 250 5 5 5 5 5 5 1 5 5 5 5 250 5 7 7 7 7 7 7 7 7 9 9 9 250 9 9 1 253 258 258 258 258 258 258 258 258 258 258 258 258 258 258 258 258 258 258 258 258 258 258 258 258 258 
5 5 5 5 5 5 5 5 5 5 5 5 251 251 251 251 251 251 251 251 251 251 251 251 251 251 251 251 251 251 251 251 251 251 251 251 251 251 251 251 251 251 251 251 251 250 5 5 5 5 5 5 9 5 5 5 5 253 261 5 7 7 7 7 7 7 7 5 5 9 253 254 255 255 258 258 258 258 258 258 258 258 258 258 258 258 258 258 258 258 258 258 258 258 258 258 258 258 258 258 
5 5 5 5 5 5 5 5 5 5 5 5 251 251 251 251 251 251 251 251 251 251 251 251 251 251 251 251 251 251 251 251 251 251 251 251 251 251 251 251 251 251 251 251 251 250 5 5 5 5 9 1 9 5 5 5 5 5 253 258 258 258 258 373 258 258 258 258 258 258 258 254 255 255 258 258 258 258 258 258 258 258 258 258 258 258 258 258 258 258 258 258 258 258 258 258 258 258 258 258 
5 5 5 5 5 5 5 5 5 5 5 5 251 251 251 251 251 251 251 251 251 251 251 251 251 251 251 251 251 251 251 251 251 251 251 251 251 251 251 251 251 251 251 251 251 250 5 5 7 7 7 9 5 5 5 5 5 5 5 5 5 5 1 9 9 47 9 1 47 9 1 9 9 9 5 5 5 5 5 5 5 5 5 5 5 5 5 5 5 5 5 5 5 5 5 5 5 5 5 5 
5 5 5 5 5 5 5 5 5 5 5 5 251 251 251 251 251 251 251 251 251 251 251 251 251 251 251 251 251 251 251 251 251 251 251 251 251 251 251 251 251 251 251 251 251 250 5 7 7 7 7 7 7 5 5 5 5 5 5 5 5 9 9 1 9 46 9 9 46 9 9 9 9 1 9 9 5 5 5 5 5 5 5 5 5 5 5 5 5 5 5 5 5 5 5 5 5 5 5 5 
5 5 5 5 5 5 5 5 5 5 5 5 258 258 258 258 258 258 258 258 258 258 258 258 258 258 258 258 258 258 258 258 258 258 258 258 261 251 251 251 251 251 251 251 251 250 5 7 7 7 7 7 7 7 5 5 5 5 5 5 9 1 9 9 9 48 1 9 48 9 9 9 9 1 9 1 9 9 9 5 5 5 5 5 5 5 5 5 5 5 5 5 5 5 5 5 5 5 5 5 
5 5 5 5 5 5 5 5 5 5 5 5 5 5 5 5 5 5 5 5 5 5 5 5 5 5 5 5 5 5 5 5 5 5 5 5 253 258 258 261 251 251 251 251 251 263 261 5 7 7 7 7 7 7 5 5 5 5 5 1 9 9 301 350 302 302 302 302 302 302 302 302 8 302 302 302 302 303 9 1 5 5 5 5 5 5 5 5 5 5 5 5 5 5 5 5 5 5 5 5 
5 5 5 5 5 5 5 5 5 5 5 5 5 5 5 5 5 5 5 5 5 5 5 5 5 5 5 5 5 5 5 5 5 5 5 5 5 5 5 253 261 251 251 251 251 251 250 5 7 7 7 7 7 7 5 5 5 5 5 5 1 301 312 350 300 300 300 300 300 300 300 300 8 300 300 300 300 311 302 303 5 5 5 5 5 5 5 5 5 5 5 5 5 5 5 5 5 5 5 5 
5 5 5 5 5 5 5 5 5 5 5 5 5 5 5 5 5 5 5 5 5 5 5 5 5 5 5 5 5 5 5 5 5 5 5 5 5 5 5 5 253 258 258 258 258 261 250 5 7 7 7 7 7 5 5 5 5 5 5 5 301 312 300 350 300 300 300 300 300 300 300 300 8 300 300 300 300 300 300 311 303 5 5 5 5 5 5 5 5 5 5 5 5 5 5 5 5 5 5 5 
5 5 5 5 5 5 5 5 5 5 5 5 5 5 5 5 5 5 5 5 5 5 5 5 5 5 5 5 5 5 5 5 5 5 5 5 5 5 5 5 5 5 5 5 5 250 263 261 7 7 7 7 7 5 5 5 5 5 5 5 304 300 300 4 300 300 300 300 300 300 300 300 8 300 300 300 300 300 300 300 311 303 5 5 5 5 5 5 5 5 5 5 5 5 5 5 5 5 5 5 
5 5 5 5 5 5 5 5 5 5 5 5 5 5 5 5 5 5 5 5 5 5 5 5 5 5 5 5 5 5 5 5 5 5 5 5 5 5 5 5 5 5 5 5 5 250 5 250 5 5 7 7 5 5 5 5 5 5 5 5 304 300 4 4 4 300 300 300 300 300 300 300 8 300 300 300 300 300 300 300 300 311 303 5 5 5 5 5 5 5 5 5 5 5 5 5 5 5 5 5 
5 5 5 5 5 5 5 5 5 5 5 5 5 5 5 5 5 5 5 5 5 5 5 5 5 5 5 5 5 5 5 5 5 5 5 5 5 5 5 5 5 5 5 5 5 250 5 250 5 5 1 9 9 9 5 5 5 5 5 5 304 300 300 4 300 300 300 300 300 300 300 300 8 300 300 300 300 300 300 300 300 300 305 5 5 5 5 5 5 5 5 5 5 5 5 5 5 5 5 5 
5 5 5 5 5 5 5 5 5 5 5 5 5 5 5 5 5 5 5 5 5 5 5 5 5 5 5 5 5 5 5 5 5 5 5 5 5 5 5 5 5 5 5 5 5 253 261 250 5 5 5 9 1 9 9 5 5 5 5 5 304 300 300 300 300 300 300 300 300 300 300 300 8 300 300 300 300 300 300 300 300 300 305 5 5 5 5 5 5 5 5 5 5 5 5 5 5 5 5 5 
5 5 5 5 5 5 5 5 5 5 5 5 5 5 5 5 5 5 5 5 5 5 5 5 5 5 5 5 5 5 5 5 5 5 5 5 5 5 5 5 5 5 5 5 5 5 250 250 5 5 5 9 9 7 7 7 7 5 5 5 306 310 300 300 300 300 300 300 300 300 300 300 8 300 300 300 300 300 300 300 300 300 305 5 5 5 5 5 5 5 5 5 5 5 5 5 5 5 5 5 
5 5 5 5 5 5 5 5 5 5 5 5 5 5 5 5 5 5 5 5 5 5 5 5 5 5 5 5 5 5 5 5 5 5 5 5 5 5 5 5 5 5 5 5 5 5 250 263 261 5 5 5 7 7 7 7 7 7 5 5 5 306 310 300 300 300 300 300 300 300 300 300 8 300 300 300 300 300 300 300 300 300 305 5 5 5 5 5 5 5 5 5 5 5 5 5 5 5 5 5 
5 5 5 5 5 5 5 5 5 5 5 5 5 5 5 5 5 5 5 5 5 5 5 5 5 5 5 5 5 5 5 5 5 5 5 5 5 5 5 5 5 5 5 5 5 5 5 261 263 258 261 5 5 7 7 7 7 7 7 5 5 5 306 310 300 300 300 300 300 300 300 300 8 300 300 300 300 300 300 300 300 300 311 303 5 5 5 5 5 5 5 5 5 5 5 5 5 5 5 5 
5 5 5 5 5 5 5 5 5 5 5 5 5 5 5 5 5 5 5 5 5 5 5 5 5 5 5 5 5 5 5 5 5 5 5 5 5 5 5 5 5 5 5 5 5 5 5 250 251 251 263 261 5 5 7 7 7 7 7 7 5 5 5 304 300 300 300 300 300 300 300 300 4 300 300 300 300 300 300 300 300 300 300 305 5 5 5 5 5 5 5 5 5 5 5 5 5 5 5 5 
5 5 5 5 5 5 5 5 5 5 5 5 5 5 5 5 5 5 5 5 5 5 5 5 5 5 5 5 5 5 5 5 5 5 5 5 5 5 5 5 5 5 5 5 5 5 5 253 261 251 251 250 5 5 7 7 7 7 5 5 5 5 5 304 300 300 300 300 300 300 300 4 4 4 300 300 300 300 300 300 300 300 300 305 5 5 5 5 5 5 5 5 5 5 5 5 5 5 5 5 
5 5 5 5 5 5 5 5 5 5 5 5 5 5 5 5 5 5 5 5 5 5 5 5 5 5 5 5 5 5 5 5 5 5 5 5 5 5 5 5 5 5 5 5 5 5 5 5 253 261 251 263 261 5 5 7 7 5 5 5 5 5 301 312 300 300 300 300 300 300 300 300 4 300 300 300 300 300 300 300 300 300 300 305 5 5 5 5 5 5 5 5 5 5 5 5 5 5 5 5 
5 5 5 5 5 5 5 5 5 5 5 5 5 5 5 5 5 5 5 5 5 5 5 5 5 5 5 5 5 5 5 5 5 5 5 5 5 5 5 5 5 5 5 5 5 5 5 5 5 250 251 251 250 5 5 9 1 5 9 5 5 301 312 300 300 300 300 300 300 300 300 300 300 300 300 300 300 300 309 307 310 300 300 305 5 5 5 5 5 5 5 5 5 5 5 5 5 5 5 5 
5 5 5 5 5 5 5 5 5 5 5 5 5 5 5 5 5 5 5 5 5 5 5 5 5 5 5 5 5 5 5 5 5 5 5 5 5 5 5 5 5 5 5 5 5 5 5 5 5 253 261 251 263 261 5 5 9 9 1 5 5 304 300 300 300 300 300 300 300 300 300 300 300 300 300 300 300 309 308 1 306 310 300 305 5 5 5 5 5 5 5 5 5 5 5 5 5 5 5 5 
5 5 5 5 5 5 5 5 5 5 5 5 5 5 5 5 5 5 5 5 5 5 5 5 5 5 5 5 5 5 5 5 5 5 5 5 5 5 5 5 5 5 5 5 5 5 5 5 5 5 253 261 251 250 5 5 5 1 9 9 5 304 300 300 300 300 300 300 300 300 300 300 300 300 300 300 300 305 1 9 9 304 309 308 5 5 5 5 5 5 5 5 5 5 5 5 5 5 5 5 
5 5 5 5 5 5 5 5 5 5 5 5 5 5 5 5 5 5 5 5 5 5 5 5 5 5 5 5 5 5 5 5 5 5 5 5 5 5 5 5 5 5 5 5 5 5 5 5 5 5 5 250 251 250 5 5 5 9 9 5 301 312 300 300 4 300 300 300 300 300 300 300 300 300 300 300 300 305 9 283 1 304 305 5 5 5 5 5 5 5 5 5 5 5 5 5 5 5 5 5 
5 5 5 5 5 5 5 5 5 5 5 5 5 5 5 5 5 5 5 5 5 5 5 5 5 5 5 5 5 5 5 5 5 5 5 5 5 5 5 5 5 5 5 5 5 5 5 5 5 5 5 253 261 263 261 5 5 9 1 9 350 350 350 4 4 4 300 300 300 300 300 300 300 300 300 300 300 311 303 9 301 312 305 5 5 5 5 5 5 5 5 5 5 5 5 5 5 5 5 5 
5 5 5 5 5 5 5 5 5 5 5 5 5 5 5 5 5 5 5 5 5 5 5 5 5 5 5 5 5 5 5 5 5 5 5 5 5 5 5 5 5 5 5 5 5 5 5 5 5 5 5 5 253 261 263 261 5 5 9 9 306 307 310 300 4 300 300 300 309 307 307 307 307 307 307 310 300 300 311 302 312 309 308 5 5 5 5 5 5 5 5 5 5 5 5 5 5 5 5 5 
5 5 5 5 5 5 5 5 5 5 5 5 5 5 5 5 5 5 5 5 5 5 5 5 5 5 5 5 5 5 5 5 5 5 5 5 5 5 5 5 5 5 5 5 5 5 5 5 5 5 5 5 5 250 251 263 261 5 5 5 5 5 306 310 300 309 307 307 308 5 5 5 5 5 5 306 307 307 310 300 309 308 5 5 5 5 5 5 5 5 5 5 5 5 5 5 5 5 5 5 
5 5 5 5 5 5 5 5 5 5 5 5 5 5 5 5 5 5 5 5 5 5 5 5 5 5 5 5 5 5 5 5 5 5 5 5 5 5 5 5 5 5 5 5 5 5 5 5 5 5 5 5 5 253 261 251 250 5 5 5 5 5 5 306 307 308 5 5 5 5 5 5 5 5 5 5 5 5 306 307 308 5 5 5 5 5 5 5 5 5 5 5 5 5 5 5 5 5 5 5 
5 5 5 5 5 5 5 5 5 5 5 5 5 5 5 5 5 5 5 5 5 5 5 5 5 5 5 5 5 5 5 5 5 5 5 5 5 5 5 5 5 5 5 5 5 5 5 5 5 5 5 5 5 5 253 261 250 5 5 5 5 5 5 5 5 5 5 5 5 5 5 5 5 5 5 5 5 5 5 5 5 5 5 5 5 5 5 5 5 5 5 5 5 5 5 5 5 5 5 5 
5 5 5 5 5 5 5 5 5 5 5 5 5 5 5 5 5 5 5 5 5 5 5 5 5 5 5 5 5 5 5 5 5 5 5 5 5 5 5 5 5 5 5 5 5 5 5 5 5 5 5 5 5 5 5 250 250 5 5 5 5 5 5 5 5 5 5 5 5 5 5 5 5 5 5 5 5 5 5 5 5 5 5 5 5 5 5 5 5 5 5 5 5 5 5 5 5 5 5 5 
5 5 5 5 5 5 5 5 5 5 5 5 5 5 5 5 5 5 5 5 5 5 5 5 5 5 5 5 5 5 5 5 5 5 5 5 5 5 5 5 5 5 5 5 5 5 5 5 5 5 5 5 5 5 5 250 250 5 5 5 5 5 5 5 5 5 5 5 5 5 5 5 5 5 5 5 5 5 5 5 5 5 5 5 5 5 5 5 5 5 5 5 5 5 5 5 5 5 5 5 
5 5 5 5 5 5 5 5 5 5 5 5 5 5 5 5 5 5 5 5 5 5 5 5 5 5 5 5 5 5 5 5 5 5 5 5 5 5 5 5 5 5 5 5 5 5 5 5 5 5 5 5 5 5 5 250 250 5 5 5 5 5 5 5 5 5 5 5 5 5 5 5 5 5 5 5 5 5 5 5 5 5 5 5 5 5 5 5 5 5 5 5 5 5 5 5 5 5 5 5 
5 5 5 5 5 5 5 5 5 5 5 5 5 5 5 5 5 5 5 5 5 5 5 5 5 5 5 5 5 5 5 5 5 5 5 5 5 5 5 5 5 5 5 5 5 5 5 5 5 5 5 5 5 5 5 250 263 258 258 258 258 258 258 258 258 258 258 258 258 258 258 258 258 258 258 258 258 258 258 258 258 258 258 258 258 258 258 258 258 258 258 258 258 258 258 258 258 258 258 258 
5 5 5 5 5 5 5 5 5 5 5 5 5 5 5 5 5 5 5 5 5 5 5 5 5 5 5 5 5 5 5 5 5 5 5 5 5 5 5 5 5 5 5 5 5 5 5 5 5 5 5 5 5 5 5 253 258 258 258 258 258 258 258 258 258 258 258 258 258 258 258 258 258 258 258 258 258 258 258 258 258 258 258 258 258 258 258 258 258 258 258 258 258 258 258 258 258 258 258 258 
5 5 5 5 5 5 5 5 5 5 5 5 5 5 5 5 5 5 5 5 5 5 5 5 5 5 5 5 5 5 5 5 5 5 5 5 5 5 5 5 5 5 5 5 5 5 5 5 5 5 5 5 5 5 5 5 5 5 5 5 5 5 5 5 5 5 5 5 5 5 5 5 5 5 5 5 5 5 5 5 5 5 5 5 5 5 5 5 5 5 5 5 5 5 5 5 5 5 5 5 
5 5 5 5 5 5 5 5 5 5 5 5 5 5 5 5 5 5 5 5 5 5 5 5 5 5 5 5 5 5 5 5 5 5 5 5 5 5 5 5 5 5 5 5 5 5 5 5 5 5 5 5 5 5 5 5 5 5 5 5 5 5 5 5 5 5 5 5 5 5 5 5 5 5 5 5 5 5 5 5 5 5 5 5 5 5 5 5 5 5 5 5 5 5 5 5 5 5 5 5 
5 5 5 5 5 5 5 5 5 5 5 5 5 5 5 5 5 5 5 5 5 5 5 5 5 5 5 5 5 5 5 5 5 5 5 5 5 5 5 5 5 5 5 5 5 5 5 5 5 5 5 5 5 5 5 5 5 5 5 5 5 5 5 5 5 5 5 5 5 5 5 5 5 5 5 5 5 5 5 5 5 5 5 5 5 5 5 5 5 5 5 5 5 5 5 5 5 5 5 5 
5 5 5 5 5 5 5 5 5 5 5 5 5 5 5 5 5 5 5 5 5 5 5 5 5 5 5 5 5 5 5 5 5 5 5 5 5 5 5 5 5 5 5 5 5 5 5 5 5 5 5 5 5 5 5 5 5 5 5 5 5 5 5 5 5 5 5 5 5 5 5 5 5 5 5 5 5 5 5 5 5 5 5 5 5 5 5 5 5 5 5 5 5 5 5 5 5 5 5 5 
5 5 5 5 5 5 5 5 5 5 5 5 5 5 5 5 5 5 5 5 5 5 5 5 5 5 5 5 5 5 5 5 5 5 5 5 5 5 5 5 5 5 5 5 5 5 5 5 5 5 5 5 5 5 5 5 5 5 5 5 5 5 5 5 5 5 5 5 5 5 5 5 5 5 5 5 5 5 5 5 5 5 5 5 5 5 5 5 5 5 5 5 5 5 5 5 5 5 5 5 
5 5 5 5 5 5 5 5 5 5 5 5 5 5 5 5 5 5 5 5 5 5 5 5 5 5 5 5 5 5 5 5 5 5 5 5 5 5 5 5 5 5 5 5 5 5 5 5 5 5 5 5 5 5 5 5 5 5 5 5 5 5 5 5 5 5 5 5 5 5 5 5 5 5 5 5 5 5 5 5 5 5 5 5 5 5 5 5 5 5 5 5 5 5 5 5 5 5 5 5 
5 5 5 5 5 5 5 5 5 5 5 5 5 5 5 5 5 5 5 5 5 5 5 5 5 5 5 5 5 5 5 5 5 5 5 5 5 5 5 5 5 5 5 5 5 5 5 5 5 5 5 5 5 5 5 5 5 5 5 5 5 5 5 5 5 5 5 5 5 5 5 5 5 5 5 5 5 5 5 5 5 5 5 5 5 5 5 5 5 5 5 5 5 5 5 5 5 5 5 5 
5 5 5 5 5 5 5 5 5 5 5 5 5 5 5 5 5 5 5 5 5 5 5 5 5 5 5 5 5 5 5 5 5 5 5 5 5 5 5 5 5 5 5 5 5 5 5 5 5 5 5 5 5 5 5 5 5 5 5 5 5 5 5 5 5 5 5 5 5 5 5 5 5 5 5 5 5 5 5 5 5 5 5 5 5 5 5 5 5 5 5 5 5 5 5 5 5 5 5 5 
5 5 5 5 5 5 5 5 5 5 5 5 5 5 5 5 5 5 5 5 5 5 5 5 5 5 5 5 5 5 5 5 5 5 5 5 5 5 5 5 5 5 5 5 5 5 5 5 5 5 5 5 5 5 5 5 5 5 5 5 5 5 5 5 5 5 5 5 5 5 5 5 5 5 5 5 5 5 5 5 5 5 5 5 5 5 5 5 5 5 5 5 5 5 5 5 5 5 5 5 
5 5 5 5 5 5 5 5 5 5 5 5 5 5 5 5 5 5 5 5 5 5 5 5 5 5 5 5 5 5 5 5 5 5 5 5 5 5 5 5 5 5 5 5 5 5 5 5 5 5 5 5 5 5 5 5 5 5 5 5 5 5 5 5 5 5 5 5 5 5 5 5 5 5 5 5 5 5 5 5 5 5 5 5 5 5 5 5 5 5 5 5 5 5 5 5 5 5 5 5 
