251 251 251 251 251 251 251 251 251 251 251 251 251 251 251 251 252 252 252 252 252 252 252 5 5 249 5 5 5 5 5 5 5 5 5 5 5 5 5 5 5 5 5 5 5 5 5 5 5 5 5 5 5 5 5 5 5 5 5 5 5 5 5 5 5 5 9 9 9 9 14 6 13 9 9 9 9 9 9 5 5 5 5 5 5 5 5 5 5 5 5 5 5 5 5 5 5 5 5 5 
251 251 251 251 251 251 251 251 251 251 251 251 251 251 251 251 252 252 252 252 252 252 252 5 5 5 5 249 5 5 5 5 5 5 5 5 5 5 5 5 5 5 5 5 5 5 5 5 5 5 5 5 5 5 5 5 5 5 5 5 5 5 5 5 5 5 9 9 9 9 14 6 13 9 9 9 9 9 9 5 5 5 5 5 5 5 5 5 5 5 5 5 5 5 5 5 5 5 5 5 
251 251 251 251 251 251 251 251 251 251 251 251 251 251 251 251 252 252 252 252 252 252 252 249 249 5 249 5 5 5 5 5 5 5 5 5 5 5 5 5 5 5 5 5 5 5 5 5 5 5 5 5 5 5 5 5 5 5 5 5 5 5 5 5 5 5 9 9 9 9 114 115 116 9 9 9 9 9 9 5 5 5 5 5 5 5 5 5 5 5 5 5 5 5 5 5 5 5 5 5 
251 251 251 251 251 251 251 251 251 251 251 251 251 251 251 251 252 252 252 252 252 252 252 5 5 484 249 5 5 5 5 5 5 5 5 5 5 5 5 5 5 5 5 5 5 5 5 5 5 5 5 5 5 5 5 5 5 5 5 5 5 5 5 5 5 5 5 5 5 186 117 118 119 188 5 5 5 5 5 5 5 5 5 5 5 5 5 5 5 5 5 5 5 5 5 5 5 5 5 5 
251 251 251 251 251 251 251 251 251 251 251 251 251 251 251 251 252 252 252 252 252 252 252 249 5 249 484 5 249 5 5 5 5 5 5 5 5 5 5 5 5 5 5 5 5 5 5 5 5 5 5 5 5 5 5 5 5 5 5 5 5 5 5 5 5 5 5 5 5 190 191 191 191 192 5 5 5 5 5 5 5 5 5 5 5 5 5 5 5 5 5 5 5 5 5 5 5 5 5 5 
251 251 251 251 251 251 251 251 251 251 251 251 251 251 251 251 252 252 252 252 252 252 252 5 249 1 5 9 5 5 5 5 5 5 484 5 5 5 5 5 5 5 5 5 5 5 5 5 5 5 5 5 5 5 5 5 5 5 5 5 5 5 5 5 5 5 5 5 5 195 196 196 196 197 5 5 5 5 5 5 5 5 5 5 5 5 5 5 5 5 5 5 5 5 5 5 5 5 5 5 
251 251 251 251 251 251 251 251 251 251 251 251 251 251 251 262 264 252 252 252 252 252 252 9 5 484 249 5 484 5 9 5 5 5 5 5 5 5 5 5 5 5 5 5 5 5 5 5 5 5 5 5 5 5 5 5 5 5 5 5 5 5 5 5 5 5 5 5 5 126 127 128 129 130 5 5 5 5 5 5 5 5 5 5 5 5 5 5 5 5 5 5 5 5 5 5 5 5 5 5 
251 251 251 251 251 251 251 251 251 251 251 251 251 251 251 252 251 252 252 252 252 252 260 271 5 5 9 5 5 249 5 249 484 5 5 5 5 5 5 5 5 5 5 5 5 5 5 5 5 5 5 5 5 5 5 5 5 5 5 5 9 5 5 484 5 5 5 1 5 131 132 133 134 135 5 5 484 5 5 9 5 5 5 5 5 5 5 5 5 5 5 5 5 5 5 5 5 5 5 5 
251 251 251 251 251 251 251 251 251 251 251 251 251 251 251 252 251 252 252 252 252 260 268 260 257 271 9 1 9 484 5 5 5 9 5 5 5 5 5 5 5 5 5 5 5 5 5 5 5 5 5 484 5 5 5 5 5 5 5 9 484 5 1 5 5 484 5 9 9 9 136 137 138 9 9 9 5 9 484 5 484 5 5 5 5 5 5 5 5 5 5 5 5 5 5 5 5 5 5 5 
251 251 251 251 251 251 251 251 251 251 251 251 251 251 251 252 251 252 252 252 260 268 260 260 268 260 271 9 5 5 5 5 484 484 484 484 5 5 5 5 5 5 5 5 5 5 5 5 5 5 5 9 5 5 5 484 5 5 5 5 5 484 5 7 249 9 9 249 9 9 14 6 13 9 9 9 9 7 7 5 1 5 484 5 5 5 5 5 5 5 5 5 5 5 5 5 5 5 5 5 
251 251 251 251 251 251 251 251 251 251 251 251 251 251 251 252 251 252 252 260 268 260 260 268 252 251 252 1 249 5 5 5 249 5 5 249 484 5 5 5 5 5 5 5 5 484 5 5 5 484 1 5 484 9 5 5 9 9 484 1 5 7 7 7 9 9 1 9 9 9 20 11 21 9 9 9 1 9 7 7 7 484 9 5 9 5 5 5 5 5 5 5 5 5 5 5 5 5 5 5 
251 251 251 251 251 251 251 251 251 251 251 251 251 251 251 252 251 252 260 268 260 260 268 252 252 251 252 9 5 9 5 5 484 5 5 5 5 5 1 5 5 1 5 484 5 249 5 5 9 484 5 1 9 484 5 1 484 5 5 7 249 7 7 9 9 9 9 9 9 9 9 249 249 9 9 9 9 9 9 9 7 7 5 484 1 5 484 5 5 5 5 5 5 5 5 5 5 5 5 5 
251 251 251 251 251 251 251 251 251 251 251 251 251 251 251 252 251 260 268 252 251 251 252 252 252 251 252 9 5 9 9 484 9 9 9 5 5 9 5 5 5 484 249 5 5 5 1 484 484 5 1 9 9 1 5 484 5 249 7 7 9 414 9 9 9 9 9 9 9 9 249 9 249 9 1 9 249 9 249 9 9 7 7 7 7 7 5 9 484 5 5 5 5 5 5 5 5 5 5 5 
251 251 251 251 251 251 251 251 251 251 251 251 251 251 251 252 251 251 252 260 268 262 264 252 252 251 252 9 9 5 5 1 249 5 484 9 5 1 249 5 249 5 9 5 237 238 238 238 239 5 484 9 9 9 1 9 7 7 7 7 9 413 9 9 9 9 1 9 9 9 1 249 9 9 9 9 249 249 1 9 9 9 7 7 7 7 7 7 5 5 5 5 5 5 5 5 5 5 5 5 
251 251 251 251 251 251 251 251 251 251 251 251 251 262 258 264 251 251 252 251 252 252 262 264 252 251 252 9 1 249 9 5 9 5 5 5 249 5 1 9 1 5 237 238 248 236 236 236 247 238 239 1 9 9 249 7 7 7 7 1 1 9 9 9 9 249 9 9 9 9 18 16 19 9 9 9 9 9 249 9 9 9 9 9 9 9 9 7 7 484 5 5 5 5 5 5 5 5 5 5 
251 251 251 251 251 251 251 251 251 251 251 251 262 264 251 251 251 262 264 262 264 252 252 262 264 251 252 1 9 5 5 484 5 1 249 5 484 484 5 237 238 238 248 236 236 236 236 236 236 236 247 238 238 238 239 9 9 9 9 9 9 9 9 9 249 249 249 18 16 16 17 6 15 16 19 1 9 249 249 9 9 249 9 9 1 9 9 249 9 9 484 5 5 5 5 5 5 5 5 5 
251 251 251 251 251 251 251 251 251 251 251 262 264 251 251 262 258 264 262 264 262 264 252 252 251 251 252 9 9 484 5 5 484 9 5 237 238 238 238 248 236 236 236 236 236 236 236 236 236 236 236 236 236 236 247 238 238 239 9 9 9 9 1 249 9 249 9 14 6 6 6 6 6 6 13 9 9 249 9 9 9 9 9 9 9 9 9 9 1 9 5 5 484 5 5 5 5 5 5 5 
251 251 251 251 251 251 251 262 258 258 258 264 251 251 262 264 262 258 264 262 264 262 264 252 251 262 256 484 9 5 249 9 9 249 237 248 236 236 236 236 236 236 236 236 236 236 236 236 236 236 236 236 236 236 236 236 236 247 238 238 238 239 9 9 9 9 249 20 11 11 12 6 6 10 21 9 249 249 237 238 238 238 238 238 238 239 9 9 1 249 9 5 5 5 5 5 5 5 5 5 
251 251 251 251 251 251 251 252 262 258 258 258 258 258 264 262 264 262 258 264 262 264 262 264 251 252 484 484 1 9 484 237 238 238 248 236 236 236 236 236 236 236 236 236 236 236 236 236 236 236 236 236 236 236 236 236 236 236 236 236 236 247 238 238 238 239 9 9 1 9 20 11 11 21 237 238 238 238 248 236 236 236 236 236 236 247 239 249 9 5 484 5 5 5 5 5 5 5 5 5 
251 251 251 251 251 251 251 252 252 262 258 258 258 258 258 264 262 264 262 258 264 262 264 251 262 256 249 484 237 238 238 248 236 236 236 236 236 236 236 236 236 236 236 236 236 236 236 236 236 236 236 236 236 236 236 236 236 236 236 236 236 236 236 236 236 247 238 238 238 238 238 238 238 238 248 236 236 236 236 236 236 236 236 236 236 236 247 239 484 1 5 1 484 5 5 5 5 5 5 5 
251 251 251 251 251 251 251 252 252 252 262 258 258 258 258 258 264 262 264 262 258 264 262 258 256 237 238 238 248 236 236 236 236 236 236 236 236 236 236 236 236 236 236 236 236 236 236 236 236 236 236 236 236 236 236 236 236 236 236 236 236 236 236 236 236 236 236 236 236 236 236 236 236 236 236 236 236 236 236 236 236 236 236 236 236 236 236 247 238 239 5 5 5 5 5 5 5 5 5 5 
251 251 251 251 251 251 251 252 252 252 252 262 258 258 258 258 258 264 262 264 251 262 256 237 238 248 236 236 236 236 236 236 236 236 236 236 236 236 236 236 236 236 236 236 236 236 236 236 236 236 236 236 236 236 236 236 236 236 236 236 236 236 236 236 236 236 236 236 236 236 236 236 236 236 236 236 236 236 236 236 236 236 236 236 236 236 236 236 236 241 484 5 1 5 5 5 5 5 5 5 
251 251 251 251 251 251 251 252 252 252 252 252 262 258 258 258 258 258 264 262 258 256 237 248 236 236 236 236 236 236 236 236 236 236 236 236 236 236 236 236 236 236 236 236 236 236 236 236 236 236 236 236 236 236 236 236 236 236 236 236 236 236 236 236 236 236 236 236 236 236 236 236 236 236 236 236 236 236 236 236 236 236 236 236 236 236 236 236 236 241 5 9 484 5 5 5 5 5 5 5 
251 251 251 251 251 251 251 252 252 252 252 252 252 251 251 262 258 259 258 256 1 237 248 236 236 236 236 236 236 236 236 236 236 236 236 236 236 236 236 236 236 236 236 236 236 236 236 236 236 236 236 236 236 236 236 236 236 236 236 236 236 236 236 236 236 236 236 236 236 236 236 236 236 236 236 236 236 236 236 236 236 236 236 236 236 236 236 236 236 247 239 5 249 484 5 5 5 5 5 5 
251 251 251 251 251 251 251 252 252 252 252 252 252 262 258 256 9 9 9 9 9 240 236 236 236 236 236 236 236 236 236 236 236 236 236 236 236 236 236 236 236 236 236 236 236 236 236 236 236 236 236 236 236 236 236 236 236 236 236 236 236 236 236 236 236 236 236 236 236 236 236 236 236 236 236 236 236 236 236 236 236 236 236 236 236 236 236 236 236 236 241 5 5 9 5 5 5 5 5 5 
251 251 251 251 251 251 251 252 252 252 252 252 252 252 9 9 9 9 1 9 237 248 236 236 236 236 236 236 236 236 236 236 236 236 236 236 236 236 236 236 236 236 236 236 236 236 236 236 236 236 236 236 236 236 236 236 236 236 236 236 236 236 236 236 236 236 236 236 236 236 236 236 236 236 236 236 236 236 236 236 236 236 236 236 236 236 236 236 236 236 241 5 249 5 5 5 5 5 5 5 
251 251 251 251 251 251 251 252 252 252 252 252 252 252 1 9 9 9 9 237 248 236 236 236 236 236 236 236 236 236 236 236 236 236 236 236 236 236 236 236 236 236 236 236 236 236 236 236 236 236 236 236 236 236 236 236 236 236 236 236 236 236 236 236 236 236 236 236 236 236 236 236 236 236 236 236 236 236 236 236 236 236 236 236 236 236 236 236 236 236 241 5 5 5 5 5 5 5 5 5 
251 251 251 251 251 251 251 252 252 252 252 252 252 252 249 9 9 9 9 242 246 236 236 236 236 236 236 236 236 236 236 236 236 236 236 236 236 236 236 236 236 236 236 236 236 236 236 236 236 236 236 236 236 236 236 236 236 236 236 236 236 236 236 236 236 236 236 236 236 236 236 236 236 236 236 236 236 236 236 236 236 236 236 236 236 236 236 236 236 236 241 249 1 5 5 5 5 5 5 5 
251 251 251 251 251 251 251 252 252 252 252 252 252 260 257 271 9 1 9 9 242 246 236 236 236 236 236 236 236 236 236 236 236 236 236 236 236 236 236 236 236 236 236 236 236 236 236 236 236 236 236 236 236 236 236 236 236 236 236 236 236 236 236 236 236 236 236 236 236 236 236 236 236 236 236 236 236 236 236 236 236 236 236 236 236 236 236 236 236 236 241 484 5 9 5 5 5 5 5 5 
251 251 251 251 251 251 262 264 252 252 252 252 252 251 251 260 257 257 271 249 9 240 236 236 236 236 236 236 236 236 236 236 236 236 236 236 236 236 236 236 236 236 236 236 236 236 236 236 236 236 236 236 236 236 236 236 236 236 236 236 236 236 236 236 236 236 236 236 236 236 236 236 236 236 236 236 236 236 236 236 236 236 236 236 236 236 236 236 236 236 241 5 5 5 5 5 5 5 5 5 
251 251 251 251 251 251 252 251 252 252 252 252 260 260 260 260 268 251 260 257 271 240 236 236 236 236 236 236 236 236 236 236 236 236 236 236 236 236 236 236 236 236 236 236 236 236 236 236 236 236 236 236 236 236 236 236 236 236 236 236 236 236 236 236 236 236 236 236 236 236 236 236 236 236 236 236 236 236 236 236 236 236 236 236 236 236 236 236 236 245 244 249 5 5 5 5 5 5 5 5 
251 251 251 251 251 251 252 251 252 252 252 252 251 251 251 251 260 260 260 268 252 240 236 236 236 236 236 236 236 236 236 236 236 236 236 236 236 236 236 236 236 236 236 236 236 236 236 236 236 236 236 236 236 236 236 236 236 236 236 236 236 236 236 236 236 236 236 236 236 236 236 236 236 236 236 236 236 236 236 236 236 236 236 236 236 236 236 236 236 241 5 5 1 5 5 5 5 5 5 5 
251 251 251 251 251 262 264 251 252 252 252 260 260 260 260 260 260 260 268 252 252 242 243 243 246 236 236 236 236 236 236 236 236 236 236 236 236 236 236 236 236 236 236 236 236 236 236 236 236 236 236 236 236 236 236 236 236 236 236 236 236 236 236 236 236 236 236 236 236 236 236 236 236 236 236 236 236 236 236 236 236 236 236 236 236 236 236 236 236 241 5 5 5 5 5 5 5 5 5 5 
251 251 251 251 251 252 251 251 252 252 260 260 260 260 260 260 260 268 252 252 260 257 257 271 240 236 236 236 236 236 236 236 236 236 236 236 236 236 236 236 236 236 236 236 236 236 236 236 236 236 236 236 236 236 236 236 236 236 236 236 236 236 236 236 236 236 236 236 236 236 236 236 236 236 236 236 236 236 236 236 236 236 236 236 236 236 236 236 236 241 484 484 5 5 5 5 5 5 5 5 
251 251 251 251 251 252 251 251 252 260 260 260 260 260 260 260 268 252 252 252 251 251 251 252 240 236 236 236 236 236 236 236 236 236 236 236 236 236 236 236 236 236 236 236 236 236 236 236 236 236 236 236 236 236 236 236 236 236 236 236 236 236 236 236 236 236 236 236 236 236 236 236 236 236 236 236 236 236 236 236 236 236 236 236 236 236 236 236 245 244 1 5 249 5 5 5 5 5 5 5 
251 251 251 251 251 252 251 251 260 260 260 260 260 260 260 268 252 252 252 260 260 268 251 252 240 236 236 236 236 236 236 236 236 236 236 236 236 236 236 236 236 236 236 236 236 236 236 236 236 236 236 236 236 236 236 236 236 236 236 236 236 236 236 236 236 236 236 236 236 236 236 236 236 236 236 236 236 236 236 236 236 236 236 236 236 236 236 236 241 9 5 9 5 5 5 5 5 5 5 5 
251 251 251 251 251 252 251 251 251 251 251 251 251 251 251 252 252 252 260 260 268 260 268 252 240 236 236 236 236 236 236 236 236 236 236 236 236 236 236 236 236 236 236 236 236 236 236 236 236 236 236 236 236 236 236 245 243 243 246 236 236 236 236 236 236 236 236 236 236 236 236 236 236 236 236 236 236 236 236 236 236 236 236 236 236 236 236 236 241 1 5 5 5 5 5 5 5 5 5 5 
251 251 251 251 251 252 251 251 251 251 251 251 251 251 251 252 252 252 251 251 252 251 252 252 240 236 236 236 236 236 236 236 236 236 236 236 236 236 236 236 236 236 236 236 236 236 236 236 236 236 236 236 236 245 243 244 1087 1088 242 246 236 236 236 236 236 236 236 236 236 236 236 236 236 236 236 236 236 236 236 236 236 236 236 236 236 236 236 236 241 5 484 249 5 5 5 5 5 5 5 5 
251 251 251 251 251 252 251 251 251 251 251 251 251 251 251 252 252 252 251 251 252 251 252 252 240 236 236 236 236 236 236 236 236 236 236 236 236 236 236 236 236 236 236 236 236 236 236 236 236 236 236 236 245 244 1 1087 1086 1084 1088 242 246 236 236 236 236 236 236 236 236 236 236 236 236 236 236 236 236 236 236 236 236 236 236 236 236 245 243 243 244 5 5 5 9 5 5 5 5 5 5 5 
251 251 251 251 262 264 251 251 251 251 251 251 251 251 251 252 252 252 251 251 252 251 252 252 240 236 236 236 236 236 236 236 236 236 236 236 236 236 236 236 236 236 236 236 236 236 236 236 236 236 236 245 244 9 1087 1086 1069 1069 1084 1088 242 246 236 236 236 236 236 236 236 236 236 236 236 236 236 236 236 236 236 236 236 236 236 236 245 244 249 1 249 5 5 1 5 5 5 5 5 5 5 5 
251 251 251 262 264 251 251 251 251 251 251 251 251 251 251 252 252 252 251 251 260 268 252 252 240 236 236 236 236 236 236 236 236 236 236 236 236 236 236 236 236 236 236 236 236 236 236 236 236 236 236 241 9 1 1083 1069 1069 1069 1069 1084 1088 240 236 236 236 236 236 236 236 236 236 236 236 236 236 236 236 236 236 236 236 236 236 236 241 249 1 5 5 5 5 9 1 5 1 5 5 5 5 5 
251 262 258 264 251 251 251 251 251 251 251 251 251 251 251 252 252 252 251 251 251 252 252 252 240 236 236 236 236 236 236 236 236 236 236 236 236 236 236 236 236 236 236 236 236 236 236 236 236 236 236 247 238 239 1089 1081 1069 1069 1069 1069 1082 240 236 236 236 236 236 236 236 236 236 236 236 236 236 236 236 236 236 236 236 236 236 236 241 249 484 1 484 1 5 5 5 5 5 5 5 5 5 5 
262 264 251 251 251 251 251 251 251 251 262 258 258 258 258 264 264 252 251 251 251 252 252 252 240 236 236 236 236 236 236 236 236 236 236 236 236 236 236 236 236 236 236 236 236 236 236 236 236 236 236 236 236 241 9 1083 1069 1069 1069 1079 1090 240 236 236 236 236 236 236 236 236 236 236 236 236 236 236 236 236 236 236 236 236 236 236 241 484 484 484 484 5 9 5 5 5 5 5 5 5 5 5 
264 251 251 251 251 251 251 262 258 258 264 251 251 251 262 264 262 264 251 251 262 264 252 252 240 236 236 236 236 236 236 236 236 236 236 236 236 236 236 236 236 236 236 236 236 236 236 236 236 236 236 236 236 247 239 1089 1081 1079 1080 1090 1 240 236 236 236 236 236 236 236 236 236 236 236 236 236 236 236 236 236 236 236 236 236 236 241 484 1 249 5 484 5 5 5 5 5 5 5 5 5 5 
258 258 258 258 258 258 258 264 251 251 251 251 262 258 264 262 264 251 251 251 252 262 264 252 240 236 236 236 236 236 236 236 236 236 236 236 236 236 236 236 236 236 236 236 236 236 236 236 236 236 236 236 236 236 241 9 1089 1090 1 9 237 248 236 236 236 236 236 236 236 236 236 236 236 236 236 236 236 236 236 236 236 236 236 236 241 484 484 249 9 484 5 5 5 5 5 5 5 5 5 5 
251 251 251 251 251 251 251 251 251 251 262 258 264 262 258 264 251 262 258 258 264 252 262 256 240 236 236 236 236 236 236 236 236 236 236 236 236 236 236 236 236 236 236 236 236 236 236 236 236 236 236 236 236 236 241 1 9 9 9 237 248 236 236 236 236 236 236 236 236 236 236 236 236 236 236 236 236 236 236 236 236 236 236 236 241 249 484 5 1 5 249 5 5 5 5 5 5 5 5 5 
251 251 251 251 251 251 251 251 251 262 264 262 258 264 251 262 258 264 251 262 258 264 252 237 248 236 236 236 236 236 236 236 236 236 236 236 236 236 236 236 236 236 236 236 236 236 236 236 236 236 236 236 236 236 247 238 238 238 238 248 236 236 236 236 236 236 236 236 236 236 236 236 236 236 236 236 236 236 236 236 236 236 236 236 241 5 249 249 5 5 5 5 5 5 5 5 5 5 5 5 
251 251 251 251 251 262 258 258 258 264 262 264 251 251 262 264 251 251 251 252 262 258 256 240 236 236 236 236 236 236 236 236 236 236 236 236 236 236 236 236 236 236 236 236 236 236 236 236 236 236 236 236 236 236 236 236 236 236 236 236 236 236 236 236 236 236 236 236 236 236 236 236 236 236 236 236 236 236 236 236 236 236 236 236 241 9 484 1 484 5 5 5 5 5 5 5 5 5 5 5 
258 258 258 258 258 264 262 258 258 258 264 251 262 258 264 251 262 258 258 264 252 1 237 248 236 236 236 236 236 236 236 236 236 236 236 236 236 236 236 236 236 236 236 236 236 236 236 236 236 236 236 236 236 236 236 236 236 236 236 236 236 236 236 236 236 236 236 236 236 236 236 236 236 236 236 236 236 236 236 236 236 236 236 245 244 484 9 5 249 1 5 5 5 5 5 5 5 5 5 5 
258 258 258 258 258 258 264 262 258 258 258 258 264 251 262 258 264 262 258 258 256 237 248 236 236 236 236 236 236 236 236 236 236 236 236 236 236 236 236 236 236 236 236 236 236 236 236 236 236 236 236 236 236 236 236 236 236 236 236 236 236 236 236 236 236 236 236 236 236 236 236 236 236 236 236 236 236 236 236 236 236 236 236 241 249 484 249 484 484 5 1 5 5 5 5 5 5 5 5 5 
258 258 258 258 258 258 258 264 262 258 258 258 258 258 264 262 258 256 9 9 237 248 236 236 236 236 236 236 236 236 236 236 236 236 236 236 236 236 236 236 236 236 236 236 236 236 236 236 236 236 236 236 236 236 236 236 236 236 236 236 236 236 236 236 236 236 236 236 236 236 236 236 236 236 236 236 236 236 236 236 236 236 236 241 249 484 484 1 484 5 5 5 5 5 5 5 5 5 5 5 
258 258 258 258 258 258 258 258 264 262 258 258 258 258 258 256 249 9 9 9 240 236 236 236 236 236 236 236 236 236 236 236 236 236 236 236 236 236 236 236 236 236 236 236 236 236 236 236 236 236 236 236 236 236 236 236 236 236 236 236 236 236 236 236 236 236 236 236 236 236 236 236 236 236 236 236 236 236 236 236 236 236 245 244 484 484 484 484 484 1 5 5 5 5 5 5 5 5 5 5 
258 258 258 258 258 258 258 258 258 256 5 5 5 5 5 5 9 9 1 237 248 236 236 236 236 236 236 236 236 236 236 236 236 236 236 236 236 236 236 236 236 236 236 236 236 236 236 236 236 236 236 236 236 236 236 236 236 236 236 236 236 236 236 236 236 236 236 236 236 236 236 236 236 236 236 236 236 236 236 236 236 236 241 249 484 1 484 5 5 9 5 5 5 5 5 5 5 5 5 5 
5 5 5 5 5 5 5 5 5 5 5 5 5 5 5 9 9 9 9 240 236 236 236 236 236 236 236 236 236 236 236 236 236 236 236 236 236 236 236 236 236 236 236 236 236 236 236 236 236 236 236 236 236 236 236 236 236 236 236 236 236 236 236 236 236 236 236 236 236 236 236 236 236 236 236 236 236 236 236 236 236 245 244 9 484 484 5 484 9 5 5 5 5 5 5 5 5 5 5 5 
5 5 5 5 5 5 5 5 5 5 5 5 5 5 249 1 9 9 5 240 236 236 236 236 236 236 236 236 236 236 236 236 236 236 236 236 236 236 236 236 236 236 236 236 236 236 236 236 236 236 236 236 236 236 236 236 236 236 236 236 236 236 236 236 236 236 236 236 236 236 236 236 236 236 236 236 236 236 236 236 236 241 484 484 484 249 5 5 5 5 1 5 5 5 5 5 5 5 5 5 
5 5 5 5 5 5 5 5 5 5 5 5 5 5 1 5 5 5 5 242 246 236 236 236 236 236 236 236 236 236 236 236 236 236 236 236 236 236 236 236 236 236 236 236 236 236 236 236 236 236 236 236 236 236 236 236 236 236 236 236 236 236 236 236 236 236 236 236 236 236 236 236 236 236 236 236 236 236 236 236 236 241 249 5 5 9 484 484 5 5 5 5 5 5 5 5 5 5 5 5 
5 5 5 5 5 5 5 5 5 5 5 5 5 5 5 249 5 5 484 5 242 246 236 236 236 236 236 236 236 236 236 236 236 236 236 236 236 245 243 243 243 243 243 243 243 243 246 236 236 236 236 236 236 236 236 236 236 236 236 236 236 236 236 236 236 236 236 236 236 236 236 236 236 236 236 236 236 236 236 236 245 244 484 249 5 484 484 1 5 5 5 5 5 5 5 5 5 5 5 5 
5 5 5 5 5 5 5 5 5 5 5 5 5 5 5 5 5 249 5 5 5 242 243 246 236 236 236 236 236 236 236 236 236 245 243 243 243 244 5 249 5 249 249 5 5 5 242 243 246 236 236 236 236 236 236 236 236 236 236 236 236 236 236 236 236 236 236 236 236 236 236 236 236 236 236 236 236 236 236 236 241 249 249 5 484 484 249 5 5 1 5 5 5 5 5 5 5 5 5 5 
5 5 5 5 5 5 5 5 5 5 5 5 5 5 5 1 5 5 5 5 484 5 484 242 243 246 236 236 236 236 245 243 243 244 5 249 249 5 5 9 5 5 249 5 5 5 5 5 242 243 243 243 243 243 246 236 236 236 236 236 236 236 236 236 236 236 236 236 236 236 236 236 236 236 236 236 236 236 236 236 241 249 5 484 1 5 5 5 5 1 5 5 5 5 5 5 5 5 5 5 
5 5 5 5 5 5 5 5 5 5 5 5 5 5 5 484 9 5 484 484 249 249 9 9 9 242 243 243 243 243 244 5 5 5 5 484 5 9 9 9 249 9 1 5 5 5 249 5 5 249 5 5 5 5 242 243 246 236 236 236 236 236 236 236 236 236 236 236 236 236 236 236 236 236 236 236 236 236 236 236 241 484 9 484 484 249 5 484 1 5 5 5 5 5 5 5 5 5 5 5 
5 5 5 5 5 5 5 5 5 5 5 5 5 5 5 5 5 5 9 5 484 5 9 1 9 5 249 5 5 1 5 5 5 9 9 5 9 9 1 9 9 1 9 249 5 5 5 5 9 9 484 5 5 5 5 9 242 243 243 243 243 243 243 243 243 243 243 243 246 236 236 236 236 236 236 236 236 236 236 236 241 249 484 484 484 9 5 5 5 5 5 5 5 5 5 5 5 5 5 5 
5 5 5 5 5 5 5 5 5 5 5 5 5 5 5 5 5 1 484 484 5 5 9 9 1 9 5 5 5 5 5 9 249 484 5 9 9 1 249 9 9 9 9 249 5 5 5 5 5 9 5 5 5 9 249 1 9 9 9 9 249 9 1 9 9 9 9 1 242 243 243 246 236 236 236 236 236 236 236 245 244 484 249 1 249 484 5 249 5 5 5 5 5 5 5 5 5 5 5 5 
5 5 5 5 5 5 5 5 5 5 5 5 5 5 5 5 484 5 5 5 9 5 249 1 9 9 5 5 249 484 5 1 9 5 9 5 5 5 5 9 9 5 9 9 5 5 484 5 5 5 5 249 9 249 9 249 9 1 484 9 1 9 9 9 484 484 484 9 9 1 9 242 246 236 236 236 236 236 236 241 9 484 484 5 5 9 9 5 5 5 5 5 5 5 5 5 5 5 5 5 
5 5 5 5 5 5 5 5 5 5 5 5 5 5 5 5 5 5 5 5 5 5 5 41 40 42 5 484 9 9 5 249 5 9 5 237 239 5 5 484 5 484 5 9 5 5 5 5 249 5 249 484 1 9 9 9 5 9 484 484 9 249 9 484 9 484 484 484 9 9 484 9 240 236 236 236 236 236 245 244 1 5 484 484 9 1 9 5 5 5 5 5 5 5 5 5 5 5 5 5 
5 5 5 5 5 5 5 5 5 5 5 5 5 5 5 5 5 5 5 5 484 5 5 1 9 9 5 5 5 1 5 9 484 237 238 248 247 239 5 5 5 9 9 1 5 5 5 5 5 5 5 9 9 1 9 484 9 484 5 484 484 9 484 484 9 9 484 484 1 9 484 9 240 236 236 236 236 236 241 9 249 484 249 5 9 249 5 5 5 5 5 5 5 5 5 5 5 5 5 5 
5 5 5 5 5 5 5 5 5 5 5 5 5 5 5 5 5 5 5 5 5 5 5 9 9 9 9 5 249 237 238 238 238 248 236 236 236 247 239 484 484 1 484 5 484 5 5 237 238 238 239 9 1 9 9 9 9 484 5 5 484 484 484 484 9 484 9 9 9 9 1 9 240 236 236 236 236 236 241 249 5 484 9 249 5 5 5 5 5 5 5 5 5 5 5 5 5 5 5 5 
5 5 5 5 5 5 5 5 5 5 5 5 5 5 5 5 5 5 5 484 5 5 5 5 9 1 9 9 237 248 236 236 236 236 236 236 236 236 241 5 9 9 484 5 5 5 237 248 236 245 244 5 9 9 9 9 1 484 484 484 484 9 9 9 9 9 9 484 484 9 9 9 240 236 236 236 236 236 241 249 484 1 5 1 5 9 5 5 5 5 5 5 5 5 5 5 5 5 5 5 
5 5 5 5 5 5 5 5 5 5 5 5 5 5 5 5 5 5 5 5 5 5 484 249 9 9 1 9 242 246 236 236 236 236 236 236 236 236 241 5 1 484 484 5 5 5 240 236 245 244 5 5 5 9 9 5 9 9 9 484 484 9 484 484 484 484 484 484 5 5 9 9 240 236 236 236 236 236 241 5 9 9 484 5 9 5 5 5 5 5 5 5 5 5 5 5 5 5 5 5 
5 5 5 5 5 5 5 5 5 5 5 5 5 5 5 5 5 5 5 5 5 5 5 484 5 5 5 484 5 242 246 236 236 236 236 236 245 243 244 5 9 9 5 5 5 237 248 245 244 5 5 5 484 5 5 5 5 5 9 9 9 9 484 249 5 484 5 5 5 1 9 237 248 236 236 236 236 236 241 484 484 9 249 249 5 5 9 5 5 5 5 5 5 5 5 5 5 5 5 5 
5 5 5 5 5 5 5 5 5 5 5 5 5 5 5 5 5 5 5 5 5 5 484 5 9 5 9 5 5 9 242 246 236 245 243 243 244 5 5 484 5 9 5 484 5 240 236 241 5 5 484 9 5 249 5 5 5 5 484 484 484 484 5 5 484 484 484 5 9 9 9 240 236 236 236 236 236 236 241 9 5 249 9 5 9 5 5 5 5 5 5 5 5 5 5 5 5 5 5 5 
5 5 5 5 5 5 5 5 5 5 5 5 5 5 5 5 5 5 5 5 5 5 5 484 5 484 1 249 5 484 5 240 245 244 5 484 5 5 9 1 484 9 484 5 5 240 236 241 5 9 1 5 5 5 5 484 5 484 484 484 5 249 5 484 484 9 9 1 5 9 9 240 236 236 236 236 236 236 241 9 249 5 1 5 5 5 5 5 5 5 5 5 5 5 5 5 5 5 5 5 
5 5 5 5 5 5 5 5 5 5 5 5 5 5 5 5 5 5 5 5 5 5 5 484 5 5 5 5 484 5 5 242 244 9 484 5 5 5 484 9 484 1 5 5 5 242 246 241 5 484 5 9 5 9 9 5 5 5 5 484 484 9 9 484 5 9 5 9 9 5 237 248 236 236 236 236 236 245 244 1 5 5 249 484 5 5 5 5 5 5 5 5 5 5 5 5 5 5 5 5 
5 5 5 5 5 5 5 5 5 5 5 5 5 5 5 5 5 5 5 5 5 5 5 5 5 5 9 484 5 1 9 5 484 1 9 484 5 5 5 9 9 9 5 484 5 5 242 244 5 5 5 484 1 5 9 9 5 5 9 5 5 5 5 5 9 484 1 9 5 9 240 236 236 236 236 236 236 241 9 5 484 249 9 9 1 5 5 5 5 5 5 5 5 5 5 5 5 5 5 5 
5 5 5 5 5 5 5 5 5 5 5 5 5 5 5 5 5 5 5 5 5 5 5 5 5 484 5 5 484 5 484 484 5 5 9 9 5 5 1 9 5 5 5 5 5 5 5 9 5 1 5 5 5 5 5 1 5 5 5 5 484 5 9 249 9 1 484 5 9 9 240 236 236 236 236 236 245 244 5 249 249 5 249 5 5 5 5 5 5 5 5 5 5 5 5 5 5 5 5 5 
5 5 5 5 5 5 5 5 5 5 5 5 5 5 5 5 5 5 5 5 5 5 5 5 5 5 5 5 249 1 5 5 1 9 484 9 5 484 9 5 5 5 5 5 5 5 5 1 5 5 484 5 484 9 5 1 484 5 484 5 5 484 9 9 9 484 484 9 1 5 240 236 236 236 236 236 241 9 5 5 9 9 1 9 5 484 5 5 5 5 5 5 5 5 5 5 5 5 5 5 
5 5 5 5 5 5 5 5 5 5 5 5 5 5 5 5 5 5 5 5 5 5 5 5 5 5 5 5 5 5 484 5 5 5 5 1 9 9 9 9 1 9 9 9 5 5 9 9 5 5 5 5 5 5 5 5 5 5 484 5 484 9 5 484 1 9 9 484 5 237 248 236 236 236 236 245 244 5 5 484 9 5 249 9 249 5 5 5 5 5 5 5 5 5 5 5 5 5 5 5 
5 5 5 5 5 5 5 5 5 5 5 5 5 5 5 5 5 5 5 5 5 5 5 5 5 5 5 5 5 5 484 5 5 484 484 484 484 484 5 9 9 9 9 1 9 9 9 5 9 9 484 5 9 1 484 5 5 1 5 5 5 5 484 484 484 484 9 1 9 240 236 236 236 236 236 241 5 5 1 5 5 9 5 5 249 5 5 5 5 5 5 5 5 5 5 5 5 5 5 5 
5 5 5 5 5 5 5 5 5 5 5 5 5 5 5 5 5 5 5 5 5 5 5 5 5 5 5 5 5 5 5 5 5 5 5 484 484 5 5 5 5 5 5 5 5 5 5 484 484 9 5 9 5 5 5 5 5 9 5 5 484 484 5 9 5 9 5 9 9 240 236 236 236 236 236 241 5 249 5 484 5 5 9 5 5 5 5 5 5 5 5 5 5 5 5 5 5 5 5 5 
5 5 5 5 5 5 5 5 5 5 5 5 5 5 5 5 5 5 5 5 5 5 5 5 5 5 5 5 5 5 5 5 5 5 5 5 5 5 5 5 5 5 5 5 5 1 9 5 5 9 5 484 5 5 1 5 5 5 5 5 5 5 9 9 9 5 9 484 9 240 236 236 236 236 236 241 484 9 5 9 249 5 1 484 5 5 5 5 5 5 5 5 5 5 5 5 5 5 5 5 
5 5 5 5 5 5 5 5 5 5 5 5 5 5 5 5 5 5 5 5 5 5 5 5 5 5 5 5 5 5 5 5 5 5 5 5 5 5 5 5 5 5 5 5 484 5 5 5 5 5 5 5 9 9 5 5 5 5 5 5 5 9 5 1 9 484 9 249 9 240 236 236 236 236 236 241 5 5 5 5 484 249 484 5 5 5 5 5 5 5 5 5 5 5 5 5 5 5 5 5 
5 5 5 5 5 5 5 5 5 5 5 5 5 5 5 5 5 5 5 5 5 5 5 5 5 5 5 5 5 5 5 5 5 5 5 5 5 5 5 5 5 5 5 5 5 5 484 484 5 5 5 5 5 5 5 5 5 5 5 5 5 5 484 9 484 484 5 1 237 248 236 236 236 236 236 247 239 484 1 5 484 1 5 5 5 5 5 5 5 5 5 5 5 5 5 5 5 5 5 5 
5 5 5 5 5 5 5 5 5 5 5 5 5 5 5 5 5 5 5 5 5 5 5 5 5 5 5 5 5 5 5 5 5 5 5 5 5 5 5 5 5 5 5 5 5 5 5 5 5 5 5 5 5 5 5 5 5 5 5 5 5 5 5 9 9 9 9 9 240 236 236 236 236 236 236 236 241 5 484 5 5 9 5 249 5 5 5 5 5 5 5 5 5 5 5 5 5 5 5 5 
5 5 5 5 5 5 5 5 5 5 5 5 5 5 5 5 5 5 5 5 5 5 5 5 5 5 5 5 5 5 5 5 5 5 5 5 5 5 5 5 5 5 5 5 5 5 5 5 5 5 5 5 5 5 5 5 5 5 5 5 5 5 5 1 249 9 9 9 240 236 236 236 236 236 236 236 247 239 5 5 484 9 5 249 5 5 5 5 5 5 5 5 5 5 5 5 5 5 5 5 
5 5 5 5 5 5 5 5 5 5 5 5 5 5 5 5 5 5 5 5 5 5 5 5 5 5 5 5 5 5 5 5 5 5 5 5 5 5 5 5 5 5 5 5 5 5 5 5 5 5 5 5 5 5 5 5 5 5 5 5 5 5 5 9 5 9 1 9 240 236 236 236 236 236 236 236 236 241 5 1 5 249 5 249 5 5 5 5 5 5 5 5 5 5 5 5 5 5 5 5 
5 5 5 5 5 5 5 5 5 5 5 5 5 5 5 5 5 5 5 5 5 5 5 5 5 5 5 5 5 5 5 5 5 5 5 5 5 5 5 5 5 5 5 5 5 5 5 5 5 5 5 5 5 5 5 5 5 5 5 5 5 5 5 5 5 9 5 9 242 246 236 236 236 236 236 236 236 247 239 249 5 9 5 5 5 5 5 5 5 5 5 5 5 5 5 5 5 5 5 5 
5 5 5 5 5 5 5 5 5 5 5 5 5 5 5 5 5 5 5 5 5 5 5 5 5 5 5 5 5 5 5 5 5 5 5 5 5 5 5 5 5 5 5 5 5 5 5 5 5 5 5 5 5 5 5 5 5 5 5 5 5 5 5 5 5 5 5 1 9 242 246 236 236 236 236 236 236 236 241 5 9 9 484 5 5 5 5 5 5 5 5 5 5 5 5 5 5 5 5 5 
5 5 5 5 5 5 5 5 5 5 5 5 5 5 5 5 5 5 5 5 5 5 5 5 5 5 5 5 5 5 5 5 5 5 5 5 5 5 5 5 5 5 5 5 5 5 5 5 5 5 5 5 5 5 5 5 5 5 5 5 5 5 5 5 1 5 5 5 484 5 240 236 236 236 236 236 236 236 241 249 484 5 9 5 249 5 5 5 5 5 5 5 5 5 5 5 5 5 5 5 
5 5 5 5 5 5 5 5 5 5 5 5 5 5 5 5 5 5 5 5 5 5 5 5 5 5 5 5 5 5 5 5 5 5 5 5 5 5 5 5 5 5 5 5 5 5 5 5 5 5 5 5 5 5 5 5 5 5 5 5 5 5 5 5 5 5 5 5 249 1 242 246 236 236 236 236 236 245 244 9 9 5 249 5 5 5 5 5 5 5 5 5 5 5 5 5 5 5 5 5 
5 5 5 5 5 5 5 5 5 5 5 5 5 5 5 5 5 5 5 5 5 5 5 5 5 5 5 5 5 5 5 5 5 5 5 5 5 5 5 5 5 5 5 5 5 5 5 5 5 5 5 5 5 5 5 5 5 5 5 5 5 5 5 5 5 5 5 1 5 9 5 240 236 236 236 236 245 244 249 9 1 484 5 5 5 5 5 5 5 5 5 5 5 5 5 5 5 5 5 5 
5 5 5 5 5 5 5 5 5 5 5 5 5 5 5 5 5 5 5 5 5 5 5 5 5 5 5 5 5 5 5 5 5 5 5 5 5 5 5 5 5 5 5 5 5 5 5 5 5 5 5 5 5 5 5 5 5 5 5 5 5 5 5 5 5 5 5 5 5 484 5 242 243 243 243 243 244 249 9 484 5 484 5 5 5 5 5 5 5 5 5 5 5 5 5 5 5 5 5 5 
5 5 5 5 5 5 5 5 5 5 5 5 5 5 5 5 5 5 5 5 5 5 5 5 5 5 5 5 5 5 5 5 5 5 5 5 5 5 5 5 5 5 5 5 5 5 5 5 5 5 5 5 5 5 5 5 5 5 5 5 5 5 5 5 5 5 5 249 5 5 5 5 5 484 5 249 5 9 1 5 5 5 5 5 5 5 5 5 5 5 5 5 5 5 5 5 5 5 5 5 
5 5 5 5 5 5 5 5 5 5 5 5 5 5 5 5 5 5 5 5 5 5 5 5 5 5 5 5 5 5 5 5 5 5 5 5 5 5 5 5 5 5 5 5 5 5 5 5 5 5 5 5 5 5 5 5 5 5 5 5 5 5 5 5 5 5 5 484 5 1 5 484 9 9 9 5 484 5 484 5 5 5 5 5 5 5 5 5 5 5 5 5 5 5 5 5 5 5 5 5 
5 5 5 5 5 5 5 5 5 5 5 5 5 5 5 5 5 5 5 5 5 5 5 5 5 5 5 5 5 5 5 5 5 5 5 5 5 5 5 5 5 5 5 5 5 5 5 5 5 5 5 5 5 5 5 5 5 5 5 5 5 5 5 5 5 5 5 5 5 5 5 484 249 5 5 484 1 5 5 484 5 5 5 5 5 5 5 5 5 5 5 5 5 5 5 5 5 5 5 5 
5 5 5 5 5 5 5 5 5 5 5 5 5 5 5 5 5 5 5 5 5 5 5 5 5 5 5 5 5 5 5 5 5 5 5 5 5 5 5 5 5 5 5 5 5 5 5 5 5 5 5 5 5 5 5 5 5 5 5 5 5 5 5 5 5 5 5 5 5 5 5 5 5 5 5 5 5 5 5 5 5 5 5 5 5 5 5 5 5 5 5 5 5 5 5 5 5 5 5 5 
5 5 5 5 5 5 5 5 5 5 5 5 5 5 5 5 5 5 5 5 5 5 5 5 5 5 5 5 5 5 5 5 5 5 5 5 5 5 5 5 5 5 5 5 5 5 5 5 5 5 5 5 5 5 5 5 5 5 5 5 5 5 5 5 5 5 5 5 5 5 5 5 5 5 5 249 5 5 5 5 5 5 5 5 5 5 5 5 5 5 5 5 5 5 5 5 5 5 5 5 
5 5 5 5 5 5 5 5 5 5 5 5 5 5 5 5 5 5 5 5 5 5 5 5 5 5 5 5 5 5 5 5 5 5 5 5 5 5 5 5 5 5 5 5 5 5 5 5 5 5 5 5 5 5 5 5 5 5 5 5 5 5 5 5 5 5 5 5 5 5 5 5 5 5 5 5 5 5 5 5 5 5 5 5 5 5 5 5 5 5 5 5 5 5 5 5 5 5 5 5 
5 5 5 5 5 5 5 5 5 5 5 5 5 5 5 5 5 5 5 5 5 5 5 5 5 5 5 5 5 5 5 5 5 5 5 5 5 5 5 5 5 5 5 5 5 5 5 5 5 5 5 5 5 5 5 5 5 5 5 5 5 5 5 5 5 5 5 5 5 5 5 5 5 5 5 5 5 5 5 5 5 5 5 5 5 5 5 5 5 5 5 5 5 5 5 5 5 5 5 5 
5 5 5 5 5 5 5 5 5 5 5 5 5 5 5 5 5 5 5 5 5 5 5 5 5 5 5 5 5 5 5 5 5 5 5 5 5 5 5 5 5 5 5 5 5 5 5 5 5 5 5 5 5 5 5 5 5 5 5 5 5 5 5 5 5 5 5 5 5 5 5 5 5 5 5 5 5 5 5 5 5 5 5 5 5 5 5 5 5 5 5 5 5 5 5 5 5 5 5 5 
5 5 5 5 5 5 5 5 5 5 5 5 5 5 5 5 5 5 5 5 5 5 5 5 5 5 5 5 5 5 5 5 5 5 5 5 5 5 5 5 5 5 5 5 5 5 5 5 5 5 5 5 5 5 5 5 5 5 5 5 5 5 5 5 5 5 5 5 5 5 5 5 5 5 5 5 5 5 5 5 5 5 5 5 5 5 5 5 5 5 5 5 5 5 5 5 5 5 5 5 
5 5 5 5 5 5 5 5 5 5 5 5 5 5 5 5 5 5 5 5 5 5 5 5 5 5 5 5 5 5 5 5 5 5 5 5 5 5 5 5 5 5 5 5 5 5 5 5 5 5 5 5 5 5 5 5 5 5 5 5 5 5 5 5 5 5 5 5 5 5 5 5 5 5 5 5 5 5 5 5 5 5 5 5 5 5 5 5 5 5 5 5 5 5 5 5 5 5 5 5 
