5 5 5 5 5 5 5 5 5 5 5 5 5 5 5 5 5 5 5 5 5 5 5 5 9 9 9 9 1 8 8 8 5 5 5 5 5 5 5 5 5 5 5 5 5 5 5 5 5 5 5 5 5 5 5 5 5 5 5 5 5 5 5 5 5 5 5 5 5 5 5 5 5 5 5 5 5 5 5 5 5 5 5 5 5 5 5 5 5 5 5 5 5 5 5 5 5 5 5 5 
5 5 5 5 5 5 5 5 5 5 5 5 5 5 5 5 5 5 5 5 5 5 5 5 5 9 1 9 9 8 8 8 5 5 5 5 5 5 5 5 5 5 5 5 5 5 5 5 5 5 5 5 5 5 5 5 5 5 5 5 5 5 5 5 5 5 5 5 5 5 5 5 5 5 5 5 5 5 5 5 5 5 5 5 5 5 5 5 5 5 5 5 5 5 5 5 5 5 5 5 
5 5 5 5 5 5 5 5 5 5 5 5 5 5 5 5 5 5 5 5 5 5 5 5 5 5 5 5 5 8 8 8 5 5 5 5 5 5 5 5 5 5 5 5 5 5 5 5 5 5 5 5 5 5 5 5 5 5 5 5 5 5 5 5 5 5 5 5 5 5 5 5 5 5 5 5 5 5 5 5 5 5 5 5 5 5 5 5 5 5 5 5 5 5 5 5 5 5 5 5 
5 5 5 5 5 5 5 5 5 5 5 5 5 5 5 5 5 5 5 5 5 5 5 5 5 5 5 5 186 117 118 119 188 5 5 5 5 5 5 5 5 5 5 5 5 5 5 5 5 5 5 5 5 5 5 5 5 5 5 5 5 5 5 5 5 5 5 5 5 5 5 5 5 5 5 5 5 5 5 5 5 5 5 5 5 5 5 5 5 5 5 5 5 5 5 5 5 5 5 5 
5 5 5 5 5 5 5 5 5 5 5 5 5 5 5 5 5 5 5 5 5 5 5 5 5 5 5 5 190 191 191 191 192 5 5 5 5 5 5 5 5 5 5 5 5 5 5 5 5 5 5 5 5 5 5 5 5 5 5 5 5 5 5 5 5 5 5 5 5 5 5 5 5 5 5 5 5 5 5 5 5 5 5 5 5 5 5 5 5 5 5 5 5 5 5 5 5 5 5 5 
5 5 5 5 5 5 5 5 5 5 5 5 5 5 5 5 5 5 5 5 5 5 5 5 5 5 5 5 195 196 196 196 197 5 5 5 5 5 5 5 5 5 5 5 5 5 5 5 5 5 5 5 5 5 5 5 5 5 5 5 5 5 5 5 5 5 5 5 5 5 5 5 5 5 5 5 5 5 5 5 5 5 5 5 5 5 5 5 5 5 5 5 5 5 5 5 5 5 5 5 
5 5 5 5 5 5 5 5 5 5 5 5 5 5 5 5 5 5 5 5 5 5 5 5 5 5 5 5 126 127 128 129 130 5 5 5 5 484 5 5 5 9 5 9 5 5 5 5 5 5 5 5 5 5 5 5 5 5 5 5 5 5 5 5 5 5 5 5 5 5 5 5 5 5 5 5 5 5 5 5 5 5 5 5 5 5 5 5 5 5 5 5 5 5 5 5 5 5 5 5 
5 5 5 5 5 5 5 5 5 5 5 5 5 5 5 5 5 5 5 5 5 5 5 5 5 5 5 5 131 132 133 134 135 5 249 5 484 5 5 9 484 5 9 484 5 249 5 9 5 5 5 5 5 5 5 5 5 5 5 5 5 5 5 5 5 5 5 5 5 5 5 5 5 5 5 5 5 5 5 5 5 5 5 5 5 5 5 5 5 5 5 5 5 5 5 5 5 5 5 5 
5 5 5 5 5 5 5 5 5 5 5 5 5 5 5 5 5 5 5 5 5 5 5 5 5 5 5 5 5 136 137 138 1 5 5 5 9 5 484 5 484 5 249 5 9 5 5 249 5 9 5 5 5 5 5 5 5 5 5 5 5 5 5 5 5 5 5 5 5 5 5 5 5 5 5 5 5 5 5 5 5 5 5 5 5 5 5 5 5 5 5 5 5 5 5 5 5 5 5 5 
5 5 5 5 5 5 5 5 5 5 5 5 5 5 5 5 5 5 5 5 5 5 5 5 5 5 5 249 5 14 6 13 5 5 9 1 5 484 249 5 9 484 5 484 5 5 484 9 5 249 5 5 5 5 5 5 5 5 5 5 5 5 5 5 5 5 5 5 5 5 5 5 5 5 5 5 5 5 5 5 5 5 5 5 5 5 5 5 5 5 5 5 5 5 5 5 5 5 5 5 
5 5 5 5 5 5 5 5 5 5 5 5 5 5 5 5 5 5 5 5 5 5 5 5 5 249 5 5 9 14 6 13 484 1 249 9 262 258 258 258 258 258 258 258 261 249 270 257 257 257 257 257 257 257 257 257 257 271 5 5 5 5 5 5 5 5 5 5 5 5 5 5 5 5 5 5 5 5 5 5 5 5 5 5 5 5 5 5 5 5 5 5 5 5 5 5 5 5 5 5 
5 5 5 5 5 5 5 5 5 5 5 5 5 5 5 5 5 5 5 5 5 5 5 5 5 5 5 9 5 20 11 21 18 19 484 5 252 237 238 238 238 238 238 239 250 5 250 251 251 251 251 251 251 251 251 251 251 252 5 5 5 5 5 5 5 5 5 5 5 5 5 5 5 5 5 5 5 5 5 5 5 5 5 5 5 5 5 5 5 5 5 5 5 5 5 5 5 5 5 5 
5 5 5 5 5 5 5 5 5 5 5 5 5 5 5 5 5 5 5 5 5 5 5 5 5 5 249 5 484 5 1 18 17 13 1 5 252 240 236 245 243 243 246 241 250 484 250 251 251 251 251 251 251 251 251 251 251 252 5 5 5 5 5 5 5 5 5 5 5 5 5 5 5 5 5 5 5 5 5 5 5 5 5 5 5 5 5 5 5 5 5 5 5 5 5 5 5 5 5 5 
5 5 5 5 5 5 5 5 5 5 5 5 5 5 5 5 5 5 5 5 5 5 5 5 249 5 9 5 1 5 5 14 6 13 5 484 252 240 236 241 9 484 240 241 253 261 263 261 251 267 260 260 260 260 260 260 260 257 271 5 5 5 5 5 5 5 5 5 5 5 5 5 5 5 5 5 5 5 5 5 5 5 5 5 5 5 5 5 5 5 5 5 5 5 5 5 5 5 5 5 
5 5 5 5 5 5 5 5 5 5 5 5 5 5 5 5 5 5 5 5 5 5 5 5 9 9 5 9 5 5 484 20 11 21 484 5 252 240 236 241 1 237 248 241 1 253 261 250 251 250 267 260 260 260 260 260 260 251 252 5 5 5 5 5 5 5 5 5 5 5 5 5 5 5 5 5 5 5 5 5 5 5 5 5 5 5 5 5 5 5 5 5 5 5 5 5 5 5 5 5 
257 257 257 257 257 257 257 257 257 257 257 257 257 257 257 257 257 257 257 257 271 5 5 5 249 9 262 258 258 258 258 258 373 258 258 258 256 242 246 247 238 248 236 241 249 484 250 250 251 250 250 258 258 258 258 258 258 258 256 5 5 5 5 5 5 5 5 5 5 5 5 5 5 5 5 5 5 5 5 5 5 5 5 5 5 5 5 5 5 5 5 5 5 5 5 5 5 5 5 5 
260 260 260 260 260 260 260 260 260 260 260 260 260 260 260 260 260 260 260 260 257 257 271 5 9 5 252 5 9 9 1 9 1 9 484 249 9 1 242 243 243 243 243 244 1 9 250 250 251 250 250 249 1 9 9 484 1 484 270 257 257 257 257 257 257 257 257 257 257 257 257 257 257 257 257 257 257 257 257 257 257 271 5 5 5 5 5 5 5 5 5 5 5 5 5 5 5 5 5 5 
251 251 251 251 251 251 251 251 251 251 251 251 251 251 251 251 251 251 251 251 251 251 252 249 5 5 252 262 258 258 373 258 258 373 258 258 258 373 258 258 258 258 258 261 484 9 250 250 251 250 250 484 9 1 9 9 9 9 250 258 267 260 260 260 260 260 260 260 260 260 260 260 260 260 260 260 260 260 260 260 268 252 5 5 5 5 5 5 5 5 5 5 5 5 5 5 5 5 5 5 
251 251 251 251 251 251 251 251 251 251 251 251 251 251 251 251 251 251 251 251 251 251 252 5 9 262 264 252 251 262 373 258 258 373 258 258 256 9 9 250 251 251 251 250 9 1 250 250 251 250 250 9 9 484 9 5 9 9 250 9 250 267 260 260 260 260 260 260 260 260 260 260 260 260 260 260 260 260 260 268 252 252 5 5 5 5 5 5 5 5 5 5 5 5 5 5 5 5 5 5 
251 251 251 251 251 251 251 251 251 251 251 251 251 251 251 251 251 251 251 251 251 251 252 5 5 252 262 256 262 256 9 9 47 9 9 1 9 1 484 253 261 251 251 250 1 249 250 263 261 250 263 258 373 261 9 9 9 9 250 1 250 250 267 260 260 260 260 260 260 260 260 260 260 260 260 260 260 260 268 252 252 252 5 5 5 5 5 5 5 5 5 5 5 5 5 5 5 5 5 5 
251 251 251 251 251 251 251 251 251 251 251 251 251 251 251 251 251 251 251 251 251 251 252 5 262 264 252 484 252 9 1 9 48 1 9 484 249 9 1 9 253 261 251 250 9 249 253 261 250 253 261 9 9 250 18 16 16 19 250 9 250 250 250 267 260 260 260 260 260 260 260 260 260 260 260 260 260 268 252 252 252 252 5 5 5 5 5 5 5 5 5 5 5 5 5 5 5 5 5 5 
251 251 251 251 251 251 251 251 251 251 251 251 251 251 251 251 251 251 251 251 251 251 252 5 252 262 256 1 375 1 262 258 258 258 258 258 258 258 258 258 261 263 261 250 9 9 9 250 250 9 374 9 9 250 14 6 6 13 374 9 250 250 250 250 258 258 258 258 258 258 258 258 258 258 258 258 258 264 252 252 252 252 5 5 5 5 5 5 5 5 5 5 5 5 5 5 5 5 5 5 
251 251 251 251 251 251 251 251 251 251 251 251 251 251 251 251 251 251 251 251 251 251 252 262 256 252 484 9 252 9 252 262 258 258 258 258 258 258 258 261 250 251 263 250 484 1 9 250 250 9 250 9 9 250 14 6 10 21 250 1 250 250 250 250 249 484 1 249 484 249 252 262 258 258 258 258 258 258 264 252 252 252 5 5 5 5 5 5 5 5 5 5 5 5 5 5 5 5 5 5 
251 251 251 251 251 251 251 251 251 251 251 251 251 251 251 251 251 251 251 251 251 251 252 252 249 252 9 9 252 262 264 252 237 238 238 238 238 238 239 250 263 261 251 250 9 9 1 250 250 9 250 1 249 250 20 12 13 9 250 9 250 250 250 250 1 434 435 435 435 436 252 252 262 258 258 258 258 258 258 264 252 252 5 5 5 5 5 5 5 5 5 5 5 5 5 5 5 5 5 5 
251 251 251 251 251 251 251 251 251 251 251 251 251 251 251 251 251 251 251 251 251 251 252 252 9 252 1 262 264 252 262 256 240 236 236 236 236 236 241 253 261 250 251 250 38 37 39 250 250 9 253 258 261 250 1 20 21 249 250 1 250 250 250 250 484 437 438 438 439 440 252 252 252 262 258 258 258 258 258 258 264 252 5 5 5 5 5 5 5 5 5 5 5 5 5 5 5 5 5 5 
251 251 251 251 251 251 251 251 251 251 251 251 251 251 251 251 251 251 251 251 251 262 264 252 9 252 9 252 262 264 252 237 248 236 236 236 236 236 247 239 250 263 261 250 1 9 9 374 374 9 9 484 250 250 9 9 9 484 250 9 374 374 374 374 1 441 442 443 444 445 252 252 252 252 262 258 258 258 258 258 258 256 5 5 5 5 5 5 5 5 5 5 5 5 5 5 5 5 5 5 
251 251 251 251 251 251 251 251 251 251 251 251 251 251 251 251 251 251 251 251 251 252 262 256 9 252 1 252 252 262 256 240 236 236 236 236 236 236 236 241 253 261 250 263 261 9 9 250 250 1 9 9 250 250 18 16 19 1 250 9 250 250 250 250 9 9 1 20 11 21 252 252 252 252 252 5 5 5 5 5 5 5 5 5 5 5 5 5 5 5 5 5 5 5 5 5 5 5 5 5 
251 251 251 251 251 251 251 251 251 251 251 251 251 251 251 251 251 251 251 251 251 252 252 484 1 375 9 252 252 252 237 248 236 236 245 243 243 246 236 247 239 250 263 261 250 1 484 250 250 9 9 9 250 250 14 6 13 9 250 9 250 250 250 263 258 258 258 258 373 258 264 252 252 252 252 5 5 9 9 5 5 5 5 5 5 5 5 5 5 5 5 5 5 5 5 5 5 5 5 5 
251 251 251 251 251 251 251 251 251 251 251 251 251 251 251 251 251 251 251 251 251 252 252 9 9 252 262 264 252 252 240 236 236 236 241 270 271 240 236 236 241 253 261 250 250 484 1 250 250 484 9 1 250 250 14 10 21 249 250 484 250 250 263 258 258 258 258 258 373 258 258 264 252 252 252 5 9 1 9 9 5 5 5 5 5 5 5 5 5 5 5 5 5 5 5 5 5 5 5 5 
251 251 251 251 251 251 251 251 251 251 251 251 251 251 251 251 251 251 251 251 251 252 252 1 9 252 252 262 264 252 240 236 236 236 241 253 256 240 236 236 247 239 250 250 250 9 249 250 250 249 9 484 250 250 20 21 9 484 250 484 250 263 258 258 258 258 258 258 373 258 258 258 264 252 252 9 9 9 9 9 5 5 5 5 5 5 5 5 5 5 5 5 5 5 5 5 5 5 5 5 
251 251 251 251 251 251 251 251 251 251 251 251 251 251 251 251 251 251 251 251 251 252 252 9 262 264 252 252 262 256 240 236 236 236 247 238 238 248 236 236 236 241 250 250 263 261 484 250 250 1 9 9 250 263 261 1 9 9 250 9 253 258 258 258 258 258 258 258 373 258 258 258 258 264 252 1 9 9 1 5 5 5 5 5 5 5 5 5 5 5 5 5 5 5 5 5 5 5 5 5 
251 251 251 251 251 251 251 251 251 251 251 251 251 251 251 251 251 251 251 251 251 252 252 1 252 262 264 252 252 237 248 236 236 236 236 236 236 236 236 236 236 241 250 263 261 263 261 250 253 258 373 261 263 261 250 484 9 9 250 1 9 9 1 9 9 1 9 9 9 1 484 9 1 9 252 9 9 9 5 5 5 5 5 5 5 5 5 5 5 5 5 5 5 5 5 5 5 5 5 5 
251 251 251 251 251 251 251 251 251 251 251 251 251 251 251 251 251 251 251 251 251 252 252 9 252 252 262 264 252 240 236 236 236 236 236 236 236 236 236 236 236 241 253 261 263 261 250 250 249 9 1 250 251 250 263 261 270 271 253 373 258 258 258 258 258 258 258 258 258 258 258 258 261 1 252 1 5 5 5 5 5 5 5 5 5 5 5 5 5 5 5 5 5 5 5 5 5 5 5 5 
251 251 251 251 251 251 251 251 251 251 251 251 251 251 251 251 251 251 251 251 251 252 252 1 252 252 252 262 256 240 236 236 236 236 236 236 236 236 236 236 236 247 239 253 261 250 250 250 1 9 9 250 251 263 261 250 253 256 18 16 19 249 9 9 9 9 1 9 9 9 1 249 250 484 252 9 9 5 5 5 5 5 5 5 5 5 5 5 5 5 5 5 5 5 5 5 5 5 5 5 
251 251 251 251 251 251 251 251 251 251 251 251 251 251 251 251 251 251 251 251 251 252 252 9 252 252 252 252 237 248 236 245 243 243 243 243 246 236 236 236 236 236 247 239 250 250 250 250 484 9 249 253 261 251 250 250 249 9 20 11 21 9 1 9 9 484 9 249 9 1 9 9 250 9 252 5 1 5 5 5 5 5 5 5 5 5 5 5 5 5 5 5 5 5 5 5 5 5 5 5 
251 251 251 251 251 251 251 251 251 251 251 251 251 251 251 251 251 251 251 251 251 252 252 9 252 252 252 252 240 236 245 244 484 9 1 484 242 243 243 246 236 245 243 244 250 250 250 250 9 9 9 9 250 251 250 250 1 9 262 258 258 258 258 258 373 258 258 258 258 258 258 258 250 9 252 5 9 5 5 5 5 5 5 5 5 5 5 5 5 5 5 5 5 5 5 5 5 5 5 5 
251 251 251 251 251 251 251 251 251 251 251 251 251 251 251 251 251 251 251 251 251 252 252 9 252 252 252 252 240 245 244 9 1 9 9 9 9 1 9 242 243 244 1 1 374 374 374 374 9 1 1 484 250 251 250 250 9 9 252 7 7 7 7 9 9 9 7 7 7 7 7 7 250 249 252 5 9 5 5 5 5 5 5 5 5 5 5 5 5 5 5 5 5 5 5 5 5 5 5 5 
251 251 251 251 251 251 251 251 251 251 251 251 251 251 251 251 251 251 251 251 251 252 252 1 252 252 252 252 242 244 1 9 9 237 238 239 9 484 9 9 1 9 9 270 257 257 257 257 257 257 257 257 257 257 250 250 9 9 252 257 257 257 257 257 257 257 257 257 257 257 257 257 257 257 257 271 9 9 5 5 5 5 5 5 5 5 5 5 5 5 5 5 5 5 5 5 5 5 5 5 
251 251 251 251 251 251 251 251 251 251 251 251 251 251 251 251 251 251 251 251 262 264 252 9 375 375 375 375 9 1 9 484 237 248 236 247 238 238 239 9 237 238 239 250 251 251 251 251 251 251 251 251 251 251 250 250 9 249 252 251 251 251 251 251 251 251 251 251 251 251 251 251 251 251 251 252 5 9 5 5 5 5 5 5 5 5 5 5 5 5 5 5 5 5 5 5 5 5 5 5 
251 251 251 251 251 251 251 251 251 251 251 251 251 251 251 251 251 251 251 251 252 262 256 9 252 252 252 252 237 238 238 238 248 236 236 236 236 236 247 238 248 245 244 250 251 251 251 251 251 251 251 251 251 251 250 250 1 9 252 251 251 251 251 251 251 251 251 251 251 251 251 251 251 251 251 252 5 9 9 5 5 5 5 5 5 5 5 5 5 5 5 5 5 5 5 5 5 5 5 5 
251 251 251 251 251 251 251 251 251 251 251 251 251 251 251 251 251 251 251 251 252 252 262 258 264 252 252 252 240 236 236 236 236 236 236 236 236 236 236 236 245 244 270 260 260 260 260 260 260 260 260 260 260 260 260 250 9 9 252 260 260 260 260 260 260 260 260 260 260 260 260 260 260 260 268 252 5 1 9 5 5 5 5 5 5 5 5 5 5 5 5 5 5 5 5 5 5 5 5 5 
260 260 260 260 260 260 260 260 260 260 260 260 260 260 260 260 260 260 260 260 260 260 260 260 268 252 252 252 240 236 236 236 236 236 236 236 236 236 236 236 241 270 260 260 260 260 260 260 260 260 260 260 260 260 260 250 9 1 252 251 251 251 251 251 251 251 251 251 251 251 251 251 251 251 252 252 5 9 1 5 5 5 5 5 5 5 5 5 5 5 5 5 5 5 5 5 5 5 5 5 
251 251 251 251 251 251 251 251 251 251 251 251 251 251 251 251 251 251 251 251 251 251 251 251 252 252 252 252 240 236 236 236 236 236 236 236 236 236 236 236 241 250 267 260 260 260 260 260 260 260 260 260 260 260 260 250 1 9 252 251 251 251 251 251 251 251 251 251 251 251 251 251 251 251 252 252 5 5 9 5 5 5 5 5 5 5 5 5 5 5 5 5 5 5 5 5 5 5 5 5 
251 251 251 251 251 251 251 251 251 251 251 251 251 251 251 251 251 251 251 251 251 251 251 251 252 252 252 252 240 236 236 236 236 236 236 236 236 236 236 236 241 250 250 251 251 251 267 260 260 260 260 260 260 260 260 260 4 257 260 260 260 260 260 260 260 260 260 260 260 260 260 260 260 268 252 252 5 5 9 9 5 5 5 5 5 5 5 5 5 5 5 5 5 5 5 5 5 5 5 5 
251 251 251 251 251 251 251 251 251 251 251 251 251 251 251 251 251 251 251 251 251 251 251 251 252 252 252 252 240 236 236 236 236 236 236 236 236 236 236 236 241 250 250 267 251 268 250 251 251 251 251 251 251 262 258 261 9 262 258 258 258 258 258 258 258 258 258 258 258 258 261 251 251 252 252 252 5 9 1 5 5 5 5 5 5 5 5 5 5 5 5 5 5 5 5 5 5 5 5 5 
251 251 251 251 251 251 251 251 251 251 251 251 251 251 251 251 251 251 251 251 251 251 251 251 252 252 252 252 242 246 236 236 236 236 236 236 236 236 236 236 241 250 250 253 258 256 250 258 258 258 258 258 258 256 9 253 373 256 9 7 7 9 1 9 9 9 9 9 7 7 250 251 251 252 252 252 5 9 5 5 5 5 5 5 5 5 5 5 5 5 5 5 5 5 5 5 5 5 5 5 
251 251 251 251 251 251 251 251 251 251 251 251 251 251 251 251 251 251 251 251 251 251 251 251 252 252 252 257 271 240 236 236 236 236 236 236 236 236 236 236 241 250 250 484 1 9 250 9 9 9 9 1 9 9 18 16 16 19 9 7 9 484 9 7 7 1 484 270 257 257 260 251 251 252 252 252 5 1 5 5 5 5 5 5 5 5 5 5 5 5 5 5 5 5 5 5 5 5 5 5 
251 251 251 251 251 251 251 251 251 251 251 251 251 251 251 251 251 251 251 251 251 251 251 251 252 252 252 251 252 242 246 236 236 236 236 236 236 236 236 236 241 250 250 18 16 16 250 1 9 9 9 484 9 9 14 6 6 13 9 9 1 9 9 7 7 7 1 250 251 251 251 251 251 252 252 252 9 9 5 5 5 5 5 5 5 5 5 5 5 5 5 5 5 5 5 5 5 5 5 5 
251 251 251 251 251 251 251 251 251 251 251 251 251 251 251 251 251 251 251 251 251 251 251 251 252 252 257 257 257 271 240 236 236 236 236 236 236 236 236 236 241 250 250 14 6 10 374 9 9 1 9 1 9 484 20 11 11 21 9 9 22 9 484 9 7 7 5 250 260 251 251 251 251 252 252 252 1 9 5 5 5 5 5 5 5 5 5 5 5 5 5 5 5 5 5 5 5 5 5 5 
251 251 251 251 251 251 251 251 251 251 251 251 251 251 251 251 251 251 251 251 251 251 251 251 252 252 251 251 251 252 242 246 236 236 236 236 236 236 236 236 241 250 250 14 10 21 250 257 257 257 257 257 257 257 257 257 257 257 257 257 257 257 257 257 257 257 257 260 262 258 258 258 258 264 252 252 5 9 5 5 5 5 5 5 5 5 5 5 5 5 5 5 5 5 5 5 5 5 5 5 
251 251 251 251 251 251 251 251 251 251 251 251 251 251 251 251 251 251 251 251 251 251 251 251 252 257 257 257 257 257 271 242 246 236 236 236 236 236 236 236 241 250 250 20 21 1 250 251 251 251 251 251 251 251 251 251 251 251 251 251 251 251 251 251 251 262 258 258 264 251 251 251 251 251 252 252 5 1 9 5 5 5 5 5 5 5 5 5 5 5 5 5 5 5 5 5 5 5 5 5 
251 251 251 251 251 251 251 251 251 251 251 251 251 251 251 251 251 251 251 251 251 251 251 251 252 251 251 251 251 251 251 271 240 236 236 236 236 236 236 236 241 250 250 1 9 9 250 251 251 251 251 251 251 251 251 251 251 251 251 251 251 251 251 262 258 264 251 251 251 251 251 251 251 251 252 252 5 9 1 5 5 5 5 5 5 5 5 5 5 5 5 5 5 5 5 5 5 5 5 5 
251 251 251 251 251 251 251 251 251 251 251 251 251 251 251 251 251 251 251 251 251 251 251 251 252 251 251 251 251 251 251 252 242 243 243 243 243 243 243 243 244 250 250 249 9 484 250 251 251 251 251 251 251 251 251 251 251 251 251 251 251 251 262 264 251 251 251 251 251 251 251 262 258 258 264 252 5 9 9 5 5 5 5 5 5 5 5 5 5 5 5 5 5 5 5 5 5 5 5 5 
260 260 260 260 260 260 260 260 260 260 260 260 260 260 260 260 260 260 260 260 260 260 260 260 260 260 260 260 260 260 260 257 257 257 257 257 257 257 257 257 257 257 257 271 9 9 250 251 251 251 251 251 251 251 251 251 251 251 262 258 258 258 264 251 251 251 251 262 258 258 258 264 251 251 251 252 9 9 9 9 5 5 5 5 5 5 5 5 5 5 5 5 5 5 5 5 5 5 5 5 
251 251 251 251 251 251 251 251 251 251 251 251 251 251 251 251 251 251 251 251 251 251 251 251 251 251 251 251 251 251 251 251 251 251 251 251 251 251 251 251 251 251 251 252 9 1 250 251 251 251 251 251 251 251 251 251 262 258 264 251 251 251 251 251 262 258 258 264 251 251 251 251 262 258 258 256 9 1 5 5 5 5 5 5 5 5 5 5 5 5 5 5 5 5 5 5 5 5 5 5 
251 251 251 251 251 251 251 251 251 251 251 251 251 251 251 251 251 251 251 251 251 251 251 251 251 251 251 251 251 251 251 251 251 251 251 251 251 251 251 251 251 251 251 252 484 9 250 251 251 251 251 251 251 262 258 258 264 251 251 251 251 262 258 258 264 251 251 251 251 262 258 258 256 25 26 26 26 26 26 26 26 26 26 26 26 26 368 26 26 27 5 5 5 5 5 5 5 5 5 5 
251 251 251 251 251 251 251 251 251 251 251 251 251 251 251 251 251 251 251 251 251 251 251 251 251 251 251 251 251 251 251 251 251 251 251 251 251 251 251 251 251 251 251 252 1 9 253 261 251 251 251 262 258 264 251 251 251 251 251 262 258 264 251 251 251 262 258 258 258 256 25 26 26 36 24 24 24 24 3 24 24 24 24 24 24 24 367 24 24 35 26 26 27 5 5 5 5 5 5 5 
251 251 251 251 251 251 251 251 251 251 251 251 251 251 251 251 251 251 251 251 251 251 251 251 251 251 251 251 251 251 251 251 251 251 251 251 251 251 251 251 251 251 251 252 18 19 249 250 251 251 251 252 251 251 251 251 251 262 258 264 251 251 262 258 258 256 25 26 26 26 36 24 24 24 24 24 24 24 24 24 24 24 24 24 3 24 24 367 3 24 24 24 35 26 27 5 5 5 5 5 
258 258 258 258 258 258 258 258 258 258 258 258 258 258 258 258 258 258 258 258 258 258 258 258 258 258 258 258 258 258 258 258 258 258 258 258 258 258 258 258 258 258 258 256 14 15 19 250 251 251 251 252 251 251 262 258 258 264 251 251 262 258 256 25 26 26 36 24 24 24 24 24 24 3 24 24 3 24 24 24 24 24 24 24 24 24 24 367 24 24 24 24 24 24 35 27 5 5 5 5 
5 5 5 5 5 5 5 5 5 5 5 5 5 5 5 5 5 5 5 5 5 5 143 250 250 5 5 5 5 5 5 5 5 5 5 9 1 9 9 1 9 9 9 18 17 6 13 250 251 251 262 264 262 258 264 251 251 262 258 258 256 25 26 36 24 24 24 24 24 24 24 24 24 24 24 24 24 24 24 24 24 3 24 24 24 24 24 367 24 24 3 24 24 3 24 35 26 26 26 26 
5 5 5 5 5 5 5 5 5 5 5 5 5 5 5 5 5 5 5 5 5 5 143 250 250 5 5 5 5 5 5 5 5 5 1 9 9 9 1 9 484 9 1 14 6 6 13 253 258 258 264 262 264 251 251 262 258 256 25 26 26 36 24 24 24 24 24 24 24 24 24 3 24 24 24 24 24 24 24 24 24 24 24 24 24 24 24 24 367 24 24 24 24 24 24 24 24 24 24 24 
5 5 5 5 5 5 5 5 5 5 5 5 5 5 5 5 5 5 5 5 5 5 143 250 263 258 258 258 258 258 258 258 258 258 258 258 258 258 258 258 258 258 258 258 254 255 258 258 258 258 258 264 262 258 258 256 25 26 36 3 24 24 24 3 24 24 24 3 24 24 24 24 24 24 24 24 24 3 24 24 24 24 24 24 3 24 24 24 367 24 24 24 24 24 24 24 24 24 24 3 
5 5 5 5 5 5 5 5 5 5 5 5 5 5 5 5 5 5 5 5 5 5 143 253 258 258 258 258 258 258 258 258 258 258 258 258 258 258 258 258 258 258 258 258 254 255 258 258 258 258 258 258 256 25 26 26 36 24 24 24 24 24 24 24 24 24 24 24 24 24 24 24 24 24 24 24 24 24 24 24 24 24 24 24 24 24 24 33 371 31 34 24 3 24 24 3 24 24 24 24 
5 5 5 5 5 5 5 5 5 5 5 5 5 5 5 5 5 5 5 5 5 5 143 5 9 1 5 5 9 22 249 9 144 5 5 5 5 5 5 5 5 5 5 14 6 6 13 9 1 9 9 249 9 28 24 24 24 24 24 24 24 3 24 24 24 24 24 24 24 24 3 24 24 3 24 24 24 24 24 24 24 24 24 24 24 33 31 32 5 9 30 34 24 24 24 24 24 24 24 24 
5 5 5 5 5 5 5 5 5 5 5 5 5 5 5 5 5 5 5 5 5 5 143 249 1 9 22 7 1 1 7 1 144 5 5 5 5 5 5 5 5 9 9 14 6 6 13 9 9 249 1 9 9 28 24 24 24 3 24 24 24 24 24 24 24 24 24 24 3 24 24 24 24 24 24 24 24 24 3 24 24 24 24 24 33 32 1 9 5 5 9 30 34 24 24 24 24 24 24 24 
5 5 5 5 5 5 5 5 5 5 5 5 5 5 5 5 5 5 5 5 5 5 143 22 9 1 9 9 9 22 1 7 144 5 5 5 5 5 5 9 9 1 249 14 6 6 13 9 1 9 9 9 1 28 24 24 24 24 24 24 24 24 24 24 24 24 24 24 24 24 24 24 24 24 24 24 24 24 24 24 24 24 3 24 29 9 9 249 5 5 5 9 28 24 24 24 24 24 3 24 
5 5 5 5 5 5 5 5 5 5 5 5 5 5 5 5 5 5 5 5 5 5 143 1 22 49 50 50 51 1 9 7 144 5 5 5 5 5 9 9 9 9 9 14 6 6 13 434 435 435 435 436 9 28 3 24 24 24 24 24 24 24 24 24 3 24 24 24 24 24 24 24 24 24 24 24 24 24 24 24 24 24 24 24 35 27 9 9 249 5 9 25 36 24 24 24 24 24 24 24 
5 5 5 5 5 5 5 5 5 5 5 5 5 5 5 5 5 5 5 5 5 5 143 249 1 52 53 54 55 9 1 9 144 5 5 9 9 1 9 9 1 9 9 14 6 6 13 437 438 438 439 440 9 28 24 24 24 8 8 24 3 24 24 24 24 24 24 24 24 24 3 24 24 24 24 24 24 24 24 24 24 24 24 24 24 35 27 1 249 25 26 36 24 24 24 3 24 24 24 24 
5 5 5 5 5 5 5 5 5 5 5 5 5 5 5 5 5 5 5 5 5 5 142 139 139 56 57 58 59 139 9 139 145 9 9 9 249 9 9 249 9 22 9 14 6 6 13 441 442 443 444 445 1 30 34 24 24 8 8 24 24 24 24 24 24 24 24 3 24 24 24 24 24 24 24 24 3 24 24 24 24 3 24 24 24 24 35 368 26 36 24 24 24 24 24 24 24 24 3 24 
5 5 5 5 5 5 5 5 5 5 5 5 5 5 5 5 5 5 5 5 5 5 5 5 22 14 6 15 19 1 9 9 9 9 1 62 63 64 65 66 9 5 9 14 6 6 15 16 16 17 6 15 19 9 30 31 34 8 8 24 24 24 24 24 461 467 469 470 468 461 24 24 24 3 24 24 24 24 24 24 24 24 24 24 24 24 24 367 24 24 24 24 24 24 24 24 24 24 24 33 
5 5 5 5 5 5 5 5 5 5 5 5 5 5 5 5 5 5 5 5 5 5 5 5 9 14 6 6 15 19 9 1 9 22 9 67 68 69 70 71 9 9 1 14 6 6 6 6 6 6 6 6 13 9 1 9 30 8 8 31 34 24 24 24 462 3 471 472 24 462 24 24 24 24 24 24 24 24 24 24 24 24 24 24 3 24 24 24 367 24 24 24 3 24 24 24 24 33 31 32 
5 5 5 5 5 5 5 5 5 5 5 5 5 5 5 5 5 5 5 5 5 5 5 5 249 9 12 6 6 15 19 22 9 9 9 72 73 74 75 76 1 9 5 14 6 6 6 6 6 6 6 6 13 5 9 9 14 6 6 13 30 34 24 24 462 467 473 474 468 462 3 24 24 24 3 24 24 24 24 24 24 24 24 24 24 24 24 24 367 24 24 24 24 24 24 3 24 29 5 5 
5 5 5 5 5 5 5 5 5 5 5 5 5 5 5 5 5 5 5 5 5 5 5 5 5 9 20 12 6 6 15 19 1 249 1 77 78 79 80 81 9 5 9 14 6 6 10 11 11 11 11 11 21 249 5 9 14 6 6 13 9 30 31 31 463 31 475 476 31 463 31 31 34 24 24 24 24 24 24 3 24 24 24 24 24 24 24 367 24 24 24 24 24 24 24 33 31 32 5 5 
5 5 5 5 5 5 5 5 5 5 5 5 5 5 5 5 5 5 5 5 5 5 5 5 5 22 9 20 12 6 6 15 16 16 16 16 17 6 15 16 16 16 16 17 6 6 13 9 9 5 9 1 9 9 9 1 14 6 6 13 1 5 9 9 464 466 477 478 139 464 1 9 30 31 31 34 24 24 24 24 24 24 3 24 24 24 24 367 24 33 31 31 31 31 31 32 5 5 5 5 
5 5 5 5 5 5 5 5 5 5 5 5 5 5 5 5 5 5 5 5 5 5 5 5 5 5 9 1 20 12 6 6 6 6 6 6 6 6 6 6 6 6 6 6 6 6 15 19 5 9 9 49 50 50 51 9 14 6 6 13 9 22 9 1 465 465 479 480 9 464 249 22 9 5 9 30 31 34 24 24 24 24 24 33 31 31 31 371 31 32 5 5 5 5 5 5 5 5 5 5 
5 5 5 5 5 5 5 5 5 5 5 5 5 5 5 5 5 5 5 5 5 5 5 5 5 5 5 9 249 20 12 6 6 6 6 6 6 6 6 6 6 6 6 6 6 6 6 15 19 1 9 52 53 54 55 9 14 6 6 13 5 9 140 139 9 9 481 482 9 465 9 9 9 1 22 9 5 30 31 31 31 31 31 32 5 5 5 5 5 5 5 5 5 5 5 5 5 5 5 5 
5 5 5 5 5 5 5 5 5 5 5 5 5 5 5 5 5 5 5 5 5 5 5 5 5 5 5 5 9 22 20 11 11 11 11 11 11 11 11 11 11 11 11 11 12 6 6 6 15 19 22 56 57 58 59 9 14 6 6 13 9 1 143 1 9 1 9 9 9 9 139 139 141 9 9 9 9 249 1 9 5 5 5 5 5 5 5 5 5 5 5 5 5 5 5 5 5 5 5 5 
5 5 5 5 5 5 5 5 5 5 5 5 5 5 5 5 5 5 5 5 5 5 5 5 5 5 5 5 5 5 5 5 5 9 1 9 9 9 22 9 1 9 249 9 20 12 6 6 6 15 16 17 6 15 16 16 17 6 6 13 9 9 143 9 1 9 9 1 9 9 1 9 144 5 9 9 9 9 9 9 9 5 5 5 5 5 5 5 5 5 5 5 5 5 5 5 5 5 5 5 
5 5 5 5 5 5 5 5 5 5 5 5 5 5 5 5 5 5 5 5 5 5 5 5 5 5 5 5 5 5 5 5 5 9 9 22 9 49 50 50 51 9 9 1 9 20 12 6 6 6 6 6 6 6 6 6 6 6 6 13 1 5 143 146 147 147 485 486 487 147 147 148 144 9 9 1 9 23 23 9 1 5 5 5 5 5 5 5 5 5 5 5 5 5 5 5 5 5 5 5 
5 5 5 5 5 5 5 5 5 5 5 5 5 5 5 5 5 5 5 5 5 5 5 5 5 5 5 5 5 5 5 5 5 5 249 9 1 52 53 54 55 9 82 83 84 85 20 12 6 6 6 6 6 6 6 6 6 6 6 13 9 9 142 149 150 150 150 150 150 150 150 151 145 9 22 9 9 9 9 9 9 5 5 5 5 5 5 5 5 5 5 5 5 5 5 5 5 5 5 5 
5 5 5 5 5 5 5 5 5 5 5 5 5 5 5 5 5 5 5 5 5 5 5 5 5 5 5 5 5 5 5 5 5 5 9 9 9 56 57 58 59 9 86 87 88 89 9 20 12 6 6 6 6 10 11 11 11 11 11 21 9 9 1 149 150 150 150 150 150 150 150 151 9 9 9 5 9 9 1 249 5 5 5 5 5 5 5 5 5 5 5 5 5 5 5 5 5 5 5 5 
5 5 5 5 5 5 5 5 5 5 5 5 5 5 5 5 5 5 5 5 5 5 5 5 5 5 5 5 5 5 5 5 5 5 1 22 9 14 6 13 9 9 77 91 92 93 9 1 20 12 6 6 6 15 19 9 9 5 1 9 9 5 9 152 156 156 153 154 155 156 156 157 9 1 9 22 5 5 5 5 5 5 5 5 5 5 5 5 5 5 5 5 5 5 5 5 5 5 5 5 
5 5 5 5 5 5 5 5 5 5 5 5 5 5 5 5 5 5 5 5 5 5 5 5 5 5 5 5 5 5 5 5 5 5 5 9 18 17 6 15 16 16 16 17 6 15 16 16 16 17 6 6 6 6 15 19 1 249 5 9 5 9 9 158 162 163 159 160 161 162 163 164 9 9 9 9 5 5 5 5 5 5 5 5 5 5 5 5 5 5 5 5 5 5 5 5 5 5 5 5 
5 5 5 5 5 5 5 5 5 5 5 5 5 5 5 5 5 5 5 5 5 5 5 5 5 5 5 5 5 5 5 5 5 5 5 9 14 6 6 6 6 6 6 6 6 6 6 6 6 6 6 6 6 6 6 15 19 5 22 9 9 140 139 139 141 14 6 6 6 13 9 9 1 22 9 1 5 5 5 5 5 5 5 5 5 5 5 5 5 5 5 5 5 5 5 5 5 5 5 5 
5 5 5 5 5 5 5 5 5 5 5 5 5 5 5 5 5 5 5 5 5 5 5 5 5 5 5 5 5 5 5 5 5 5 5 5 14 6 6 6 6 6 6 6 6 6 6 6 6 6 6 6 6 6 6 6 15 19 9 1 9 143 22 7 144 14 6 6 6 13 9 9 9 9 9 5 5 5 5 5 5 5 5 5 5 5 5 5 5 5 5 5 5 5 5 5 5 5 5 5 
5 5 5 5 5 5 5 5 5 5 5 5 5 5 5 5 5 5 5 5 5 5 5 5 5 5 5 5 5 5 5 5 5 5 5 5 20 11 11 11 11 11 11 11 11 11 11 11 11 11 11 11 11 12 6 6 6 15 19 9 1 142 139 139 145 14 6 6 6 13 9 5 9 9 5 5 5 5 5 5 5 5 5 5 5 5 5 5 5 5 5 5 5 5 5 5 5 5 5 5 
5 5 5 5 5 5 5 5 5 5 5 5 5 5 5 5 5 5 5 5 5 5 5 5 5 5 5 5 5 5 5 5 5 5 5 5 5 5 9 9 1 9 9 249 9 9 1 9 249 9 9 9 1 20 12 6 6 6 15 16 16 16 16 16 16 17 6 6 6 13 9 249 1 9 5 5 5 5 5 5 5 5 5 5 5 5 5 5 5 5 5 5 5 5 5 5 5 5 5 5 
5 5 5 5 5 5 5 5 5 5 5 5 5 5 5 5 5 5 5 5 5 5 5 5 5 5 5 5 5 5 5 5 5 5 5 5 5 5 5 5 9 9 249 9 9 9 249 9 1 9 1 9 249 9 20 12 6 6 6 6 6 6 6 6 6 6 6 6 6 13 1 9 9 5 5 5 5 5 5 5 5 5 5 5 5 5 5 5 5 5 5 5 5 5 5 5 5 5 5 5 
5 5 5 5 5 5 5 5 5 5 5 5 5 5 5 5 5 5 5 5 5 5 5 5 5 5 5 5 5 5 5 5 5 5 5 5 5 5 5 5 5 5 9 9 1 249 9 9 1 9 5 5 9 9 9 20 12 6 6 6 6 6 6 6 6 6 6 6 10 21 9 9 5 5 5 5 5 5 5 5 5 5 5 5 5 5 5 5 5 5 5 5 5 5 5 5 5 5 5 5 
5 5 5 5 5 5 5 5 5 5 5 5 5 5 5 5 5 5 5 5 5 5 5 5 5 5 5 5 5 5 5 5 5 5 5 5 5 5 5 5 5 5 5 5 9 9 9 5 5 5 5 5 5 1 9 1 20 11 11 11 11 11 11 11 11 11 11 11 21 1 9 5 5 5 5 5 5 5 5 5 5 5 5 5 5 5 5 5 5 5 5 5 5 5 5 5 5 5 5 5 
5 5 5 5 5 5 5 5 5 5 5 5 5 5 5 5 5 5 5 5 5 5 5 5 5 5 5 5 5 5 5 5 5 5 5 5 5 5 5 5 5 5 5 5 5 5 5 5 5 5 5 5 5 5 9 249 9 9 9 9 9 1 9 9 9 9 5 5 5 5 5 5 5 5 5 5 5 5 5 5 5 5 5 5 5 5 5 5 5 5 5 5 5 5 5 5 5 5 5 5 
5 5 5 5 5 5 5 5 5 5 5 5 5 5 5 5 5 5 5 5 5 5 5 5 5 5 5 5 5 5 5 5 5 5 5 5 5 5 5 5 5 5 5 5 5 5 5 5 5 5 5 5 5 5 5 5 5 5 1 9 23 23 23 9 1 5 5 5 5 5 5 5 5 5 5 5 5 5 5 5 5 5 5 5 5 5 5 5 5 5 5 5 5 5 5 5 5 5 5 5 
5 5 5 5 5 5 5 5 5 5 5 5 5 5 5 5 5 5 5 5 5 5 5 5 5 5 5 5 5 5 5 5 5 5 5 5 5 5 5 5 5 5 5 5 5 5 5 5 5 5 5 5 5 5 5 5 5 5 5 5 5 5 5 5 5 5 5 5 5 5 5 5 5 5 5 5 5 5 5 5 5 5 5 5 5 5 5 5 5 5 5 5 5 5 5 5 5 5 5 5 
5 5 5 5 5 5 5 5 5 5 5 5 5 5 5 5 5 5 5 5 5 5 5 5 5 5 5 5 5 5 5 5 5 5 5 5 5 5 5 5 5 5 5 5 5 5 5 5 5 5 5 5 5 5 5 5 5 5 5 5 5 5 5 5 5 5 5 5 5 5 5 5 5 5 5 5 5 5 5 5 5 5 5 5 5 5 5 5 5 5 5 5 5 5 5 5 5 5 5 5 
5 5 5 5 5 5 5 5 5 5 5 5 5 5 5 5 5 5 5 5 5 5 5 5 5 5 5 5 5 5 5 5 5 5 5 5 5 5 5 5 5 5 5 5 5 5 5 5 5 5 5 5 5 5 5 5 5 5 5 5 5 5 5 5 5 5 5 5 5 5 5 5 5 5 5 5 5 5 5 5 5 5 5 5 5 5 5 5 5 5 5 5 5 5 5 5 5 5 5 5 
5 5 5 5 5 5 5 5 5 5 5 5 5 5 5 5 5 5 5 5 5 5 5 5 5 5 5 5 5 5 5 5 5 5 5 5 5 5 5 5 5 5 5 5 5 5 5 5 5 5 5 5 5 5 5 5 5 5 5 5 5 5 5 5 5 5 5 5 5 5 5 5 5 5 5 5 5 5 5 5 5 5 5 5 5 5 5 5 5 5 5 5 5 5 5 5 5 5 5 5 
5 5 5 5 5 5 5 5 5 5 5 5 5 5 5 5 5 5 5 5 5 5 5 5 5 5 5 5 5 5 5 5 5 5 5 5 5 5 5 5 5 5 5 5 5 5 5 5 5 5 5 5 5 5 5 5 5 5 5 5 5 5 5 5 5 5 5 5 5 5 5 5 5 5 5 5 5 5 5 5 5 5 5 5 5 5 5 5 5 5 5 5 5 5 5 5 5 5 5 5 
5 5 5 5 5 5 5 5 5 5 5 5 5 5 5 5 5 5 5 5 5 5 5 5 5 5 5 5 5 5 5 5 5 5 5 5 5 5 5 5 5 5 5 5 5 5 5 5 5 5 5 5 5 5 5 5 5 5 5 5 5 5 5 5 5 5 5 5 5 5 5 5 5 5 5 5 5 5 5 5 5 5 5 5 5 5 5 5 5 5 5 5 5 5 5 5 5 5 5 5 
5 5 5 5 5 5 5 5 5 5 5 5 5 5 5 5 5 5 5 5 5 5 5 5 5 5 5 5 5 5 5 5 5 5 5 5 5 5 5 5 5 5 5 5 5 5 5 5 5 5 5 5 5 5 5 5 5 5 5 5 5 5 5 5 5 5 5 5 5 5 5 5 5 5 5 5 5 5 5 5 5 5 5 5 5 5 5 5 5 5 5 5 5 5 5 5 5 5 5 5 
5 5 5 5 5 5 5 5 5 5 5 5 5 5 5 5 5 5 5 5 5 5 5 5 5 5 5 5 5 5 5 5 5 5 5 5 5 5 5 5 5 5 5 5 5 5 5 5 5 5 5 5 5 5 5 5 5 5 5 5 5 5 5 5 5 5 5 5 5 5 5 5 5 5 5 5 5 5 5 5 5 5 5 5 5 5 5 5 5 5 5 5 5 5 5 5 5 5 5 5 
